Kevin Bacon
2045
Ulrich Zara Pratt -> Milan Valerian Santa-Cruz
Serene Isabella Elessar -> Ronin Sam Idaho
Aeryn Kelsier Serrano -> Sumayah Khan Carnegie
Yurt Sumayah Wan -> Kat Emilia Wozniak
Emilia Septima Feder -> Yuanchen Apu Miyagi
Luigi Tonya Vinson -> Sreevatsava Zelda Vought
Paul Ishna Inez -> Rylan Alishba Leibniz
Botax Ulim Daniels -> Wyrm Ximena Jakzl
Neil Xinia Armitage -> Nora Roroni Mejito
Tyrian Ryu Quetzelos -> Xena Lleshwi Murutsuma
Webster Rhaj Wan -> Ilena Quartz Ginfu
Alishba Quartz Nakagawa -> Jennifer Grint Masahiro
Sonia Jai Tehuacan -> Llan Ollie Armitage
Echo Torol Dunbar -> Zant Krishna Venli
Vortigern Aeryn Kerbochaurd -> Samus Cassiopiea Kritikos
Veebux Paris Anderson -> Shallan Vivenna Volkov
Vella Gurn Schwetzer -> Link Isolde Roshka
Raven Midna Levin -> Seltsa Eva Lezrimond
Quartz Tyrian Openheimer -> Foxx Lyn Evenstar
Xander ShaiLu Kent -> Leni Ryu Dryzt
Sonia Krin Petrovic -> Verden Maria Jakzl
Jareth Presley Armstrong -> Julio Buffalo Evenstar
Apu Korath Barnes -> Roroni Vivenna Oneida
Ilena Druzilla Blanco -> Avni Seltsa Petrovic
Deepak Fisk Westmore -> Yezier Aphra Rockafeller
Buffalo Alister Epenona -> Fenix Zarbo O'Reilly
Krishna Atreyu Kent -> Vortigern Xena Solo
Grint Botax Hernandez -> Sumayah Naruto Hyprazia
Apu HoosFoos Cheong -> Meiling Yurt Sol
Deepak Lyn Lezrimond -> Ryu Ashravan Hishla
Milan Gandalf Syushu -> Ivanka Julio Chowdury
Aeryn Chiri-Chiri Masahiro -> Yurt Ollie Kholin
Gurn Cloud Gates -> Sreevatsava Thane Sokolov
Xinia Roroni Santa-Cruz -> Honoria Sam Warplanter
Alishba Vin Wan -> Grint Bill GuYung
Ryan Luke Sentimere -> Zaraphel Sonia Elessar
Atreyu Emer Azlan -> Grint Jai Lezrimond
Han Neil Syushu -> Ulim Deepak Ashkenazi
Luke Druzilla Quetzelos -> Atskuo Gurn Icthyon
Leona Ilena Blanco -> HoosFoos Eve Kobayashi
Eva Skar Kent -> Sam Link California
Fatima Shallan Kendoshi -> Jennifer Torres
Cellin Ziggurah Norton -> Avni Cho Gerrit
Xander Milan Uxima -> Isolde Ali O'Reilly
Rylan Meiling Ogawa -> Krishna Zara Oberron
Shrivan Sylphrena Stormblessed -> Abril Earnest Kerbochaurd
Presley Gurn GuYung -> Artemis Ivanka Jung
Cellin Gwnivere Cheong -> Saanvi Grint Rubio
Lyn Zant Eagle-Feather -> Ciri Zelda Orbita
Shallan Yun Golubev -> Zarbo Jasnah Warplanter
Paris Areesha Whitman -> Manuel Lakshi Lestibourne
Yezier Apu Cillia -> Cassiopiea Cho Magnusson
Ulim Saanvi Golubev -> Guido Neil Rax
Oogex Yun Sokolov -> Jack Ulim Sokolov
Zara Zarbo Skywalker -> Isolde Grint Ikeda
Isolde Rylan Lezrimond -> Kat Geralt Rodriguez
Avni Milo Cheong -> Shallan Ryu Solaris
Ciri Xianchu Hyprazia -> Milan Gandalf Syushu
Ilya Ollie Chowdury -> Xinia Xinyi Starsitter
Sumayah Quartz Ahmed -> Leona Honoria Westmore
Llan Ishna Ogawa -> Luigi Botax Skylocke
Emilia Paul Hashimoto -> Lleshwi Shallan Orbita
Zara Zarbo Solaris -> Leona Ulrich Lannister
Septima Emilia Carnegie -> Ryan Emma Cellish
Kale Korath Lannister -> Botax Areesha Magnusson
John Emer Blanco -> Wynn Verla Lestibourne
Shrivan Frodo Dryzt -> Xena Artemis Queens
Vivenna Xena Nakagawa -> Zaraphel Vin Fandurin
Zaraphel Jasnah Lemont -> Echo Eva Wu
Geralt Ryu Iyatil -> Skar Zelda Suarez
Leni Frodo Foorl -> Ryan Aeryn Skywalker
Zelda Sim Vurnt -> Gwnivere Snimm Locke
Ronin Vin Blanco -> Krin Mehwish Hyprazia
Zant Xianchu Ramos -> Aurora Alishba Schmidt
Akio Maheen Rasmussen -> Jasnah Aeryn Anderson
Kaladin Galaria Newton -> Sonia Deepak Zanzibrot
Saanvi Khan Iyatil -> Sumayah Yezier Solaris
Tullia Abril Yoshida -> Jai Ali Zanzibrot
Link Ivanka Quetzelos -> Eve Luke Oberron
Aurora Gandalf Sol -> Sylphrena Anaya Wu
Leona Zoe Diego -> Thane Kat Melbourne
Frodo Lyn Epenona -> Tonya Zaraphel Venli
Jasnah Lyn Ogawa -> Xena Deepak Cheong
Zoe Vortigern Wojciechowski -> Fenix Ryan Earthsea
Foxx Verden Ugnaught -> Jack Shrivan Chowdury
Buffalo Alister Epenona -> Lakshi Paris Vought
Zaraphel Sreevatsava Schmidt -> Bill Frodo Ikeda
Korath Yuanchen Memnon -> Anaya Zelda Petrovic
Sumayah Zelda Dostoyevsky -> Ashravan Xianchu Miyagi
Luke Falkor Hashimoto -> Xena Ravi Hemonotz
Yurt Neil Ogawa -> Grint Rhaj Armstrong
Ishna Krin Blanco -> Isolde Grint Ikeda
Dalinar Sumayah Yeet -> Isabella Saanvi Lezrimond
Milan Artemis California -> Skar Presley Ingersoll
Antonia Jack Venli -> Manuel Eva Rasmussen
Bill Skar Kendoshi -> Guido Buffalo Schroeder
Julio Anaya Sato -> Drobyl Luke Wan
Leona Ulrich Lannister -> Julio Anaya Sato
Yurt Mehwish Solo -> Vivenna Yuanchen Venli
Eva Midna Torres -> Drobyl Shrivan Volkov
Ishna Aurora Eagle-Feather -> Link Eva Rubio
Echo Torol Gerrit -> Honoria Abril Endo
Sreevatsava Zelda Vought -> Rylan Verden Dreyfuss
Samus Wyrm Eagle-Feather -> Quartz Antonia Idaho
Sylphrena Cloud Feder -> Fatima Xinia Diego
Ollie Wyrm Lannister -> Apu Wynn Cheong
Frodo Xinyi Schroeder -> Zelda Krishna Occam
Lyn Roroni Mytaras -> Atskuo Chiri-Chiri Kondo
Sumayah Galaria Kondo -> Ronin Vin Blanco
Eden Tao Lemont -> Yezier Alister Hwang
Krishna Liv Suarez -> Midna Atreyu Pratt
Ziggurah Veebux Golubev -> Jack Isabella Syushu
Eden Oogex Starsitter -> Druzilla Ollie Halibut
Isabella Zarbo Mizrachi -> Ciri Zelda Orbita
Xena Aurora Cellish -> Deepak Falkor Miyagi
Zaraphel Eve Sato -> Naruto Eden Kent
Krishna Atreyu Kent -> Leia Cellin PorSellik
Sam HoosFoos Guyaux -> Shrivan Prisha Guyaux
Presley Jai Earthsea -> Ganondorf Kelsier Daniels
Ryu Eden Feder -> Cloud Alishba Solaris
Ilena Quartz Rubio -> Frodo Fenix Aetheryx
Manuel Ximena Zielinski -> Khan Alishba Cillia
Grint Jai Lezrimond -> Xander Aeryn Rockafeller
Abril Serene Mephistopheles -> Guido Geralt Chakma
Presley Kat Trenton -> Kaladin Natasha Centauri
Zaraphel Abril Nyad -> Xinia Ximena Lestibourne
Jai Aphra Masahiro -> Yurt Mehwish Solo
Aphra Raven Magnusson -> Ximena Jacob Pratt
Eden Jack Mizrachi -> Dalinar Xinia Daniels
Guido Corla Kritikos -> Ashravan Buffalo Kerbochaurd
Vella Ravi Iyatil -> Maria Eden Foorl
Dalinar Tao Yusuf -> Gandalf Ravi Earthsea
Jack Areesha Ramos -> Emma Emer Solo
Ollie Zelda Vurnt -> Ali Druzilla Torval
Kaladin Septima Fandurin -> Jai Ravi Ikeda
Septima Tullia Avraham -> Dalinar Tao Yusuf
Honoria Sam Warplanter -> Ajit Vin Sokolov
Ludo Eva O'Reilly -> Saanvi Tyrian Smith
Ivanka Rahab Garcia -> Eden Leona McCray
Apu Wynn Cheong -> Rin Meiling Uxima
Galaria Geralt Fandurin -> John Umbra Dunbar
Rahab Naruto Dostoyevsky -> Akio GuYung
Foxx Leni Rax -> Ulim Ali Dreyfuss
Isolde Tao Pratt -> Avni Saanvi Murutsuma
Zara Honoria Torres -> Buffalo Umbra Iyatil
HoosFoos Vella Miyagi -> Emer Lakshi Schroeder
Verla Kelsier Jentry -> Ajit Samus Anderson
Isolde Gwnivere Anderson -> Verla Paris Pratt
Dalinar Ludo GuYung -> Ivanka Tyrian Newton
Abril Earnest Kerbochaurd -> Cellin Avni Idaho
Ulim Apu Faheen -> Valerian Neil Vinson
Emma Prisha Evenstar -> Verla Bill Schroeder
Paul Earnest Vergebrand -> Ronin Aeryn Jentry
Maheen Maria Rodriguez -> Sreevatsava Cloud Lestibourne
Alishba Quartz Nakagawa -> Lior Jack Morales
Cellin Sylphrena Kritikos -> Veebux Yash Evenstar
Abril Rahab Rasmussen -> Naruto Zant Kerbochaurd
Yun Seltsa Kendoshi -> Tao Callum Volkov
Eden Leona McCray -> Akio Maheen Rasmussen
Botax Eve Skywalker -> Zara Honoria Torres
Ilya Jack Queens -> Kale Vortigern Fitzwilliam
Fisk Deepak Hishla -> Yuanchen Grint Rax
Cassiopiea Jennifer Kerbochaurd -> Eve Yun Dryzt
Verla Vella Daniels -> Oogex Guido McDonald
Gwnivere Neil Lemont -> Dalinar Xander Kondo
Sylphrena Valerian Iyatil -> Fisk Krin Yeet
Ilena Druzilla Blanco -> Cloud Mephistopheles
Vortigern Zara Jakzl -> Prisha Naruto Blanco
Druzilla John Orbita -> Veebux Kelsier Schmidt
Jareth Mehwish Dostoyevsky -> Alishba Kale Kruchev
Cloud Ilya Rasmussen -> Callum Naruto Mephistopheles
Lleshwi Nora Aetheryx -> Kelsier Yggsila Leibniz
Galaria Anaya Levin -> Sonia Natasha Jentry
Paul Earnest Vergebrand -> Jasnah Prisha Idaho
Presley Atreyu Occam -> Xena Ravi Hemonotz
Akio Saanvi Torres -> Apu Milo Kerbochaurd
Geralt Anaya Roshka -> Ivanka Julio Chowdury
Eve Milan Cheong -> Shrivan Ryu Ginfu
Galaria Ronin Evenstar -> Jacob Ali Rubio
Maheen Quartz Leibniz -> Antonia Rylan Skywalker
Ulrich Shrivan Dryzt -> Kale Lior Roshka
Samus Lyn Solaris -> Sreevatsava Fenix Masahiro
Foxx Dalinar Pratt -> Skar Khan Lezrimond
Raven Chiri-Chiri Ramos -> Emer Leni Al-Ghul
Guido Saanvi Elessar -> Frodo Jai Stormblessed
Nora Anaya Epenona -> Echo Torol Dunbar
Vin Quartz Armstrong -> Neil Roroni Morales
Sim Abril Oneida -> Leia Geralt Wan
Leni Maheen Dryzt -> Jasnah Jacob Epenona
Anaya Prisha Nakagawa -> Apu Milo Kerbochaurd
Milan Cellin McMillan -> Corla Leni Iyatil
Sam Atskuo Guyaux -> Paris Dalinar Trenton
Areesha Valerian McDonald -> Ronin Emilia Wayne
Cho Samus Hishla -> Emer Atskuo Wojciechowski
Fenix Roroni Sol -> Oogex Khan Armitage
Kaladin Shallan Openheimer -> Ollie Saanvi Nerfherder
Meiling Xianchu Garcia -> Isabella Earnest Daniels
Cassiopiea Cho Magnusson -> Ludo Garter California
Leona Gurn Uxima -> Torol Echo Torval
Yash Ulim Hwang -> Ashravan Ravi Earthsea
Guido Corla Kritikos -> Sumayah Tullia Halibut
Luke Druzilla Quetzelos -> Botax Ulim Daniels
Corla Paris Lopez -> Apu Ryan Azlan
Veebux Neil Schmidt -> Yun Yun Levin
Xinyi Roroni Gygax -> Buffalo Bill Rodriguez
Anaya Kelsier Icthyon -> Zoe Wynn Serrano
Ronin Alishba Epenona -> Gandalf Nora Hernandez
Corla Fisk Avraham -> Verla Ivanka Rodriguez
Cloud Maheen Cillia -> Ivanka Rahab Garcia
Leni Nora Lannister -> Sonia HoosFoos Xi
Ollie Zelda Vurnt -> Jennifer Aphra Oneida
Cloud Presley Barnes -> Honoria Abril Endo
Krishna Paul Jorn -> Ximena Vivenna Kwon
Manuel Apu Serrano -> Mehwish Deepak Lemont
Llan Krin Hwang -> Isolde Alister GuYung
Leona Rhaj Mytaras -> Saanvi Yash Cillia
Yurt Cloud PorSellik -> Ashravan Verla Carnegie
Vortigern Ulrich Al-Ghul -> Akio Botax Nesbit
Zant Ciri Hemonotz -> Rin Sim Ikeda
Rhaj Milan Nerfherder -> Foxx Ishna Leibniz
Falkor Manuel Vinson -> Eden Frodo Feder
Rhaj Deepak Rubio -> Ivanka Saanvi Syushu
Webster Korath Ginfu -> Jacob Dalinar Chakma
Fenix Roroni Sol -> Tyrian Areesha Dupont
Llan Vin Wan -> Wyrm Gwnivere Occam
Zara Xinia McDonald -> Xinyi Honoria Daniels
Leia Paul Orbita -> Meiling Ronin Rockafeller
Xander Xena Torres -> Presley Kat Trenton
Anaya Presley Fandurin -> Maheen Midna Wan
Saanvi Quartz Ogawa -> Natasha Eve Morales
Ximena Fenix Yamada -> Milo Frodo Yoshida
Serene Quartz Cheong -> Atreyu Abril Kruchev
Meiling Seltsa Guyaux -> HoosFoos Yezier Serrano
Maheen Quartz Smith -> Yurt Grint Mizrachi
Aurora Gandalf Sol -> Ollie Wyrm Lannister
Chiri-Chiri Ivanka Armstrong -> Rin Zara Kendoshi
Sumayah Khan Carnegie -> Jacob Rin Gygax
Leona Rhaj Mytaras -> Artemis Sylphrena Uxima
Seltsa Jacob Centauri -> Natasha Garter Whitman
Seltsa Verla Murutsuma -> Galaria Earnest Petrovic
Veebux Paris Anderson -> Alister Khan Solo
Krin Milan Rax -> Neil Ximena Ibrahim
Sylphrena Frodo Inez -> Botax Areesha Magnusson
Sim Midna Syushu -> Xianchu Khan Torres
Cloud Ulrich Lezrimond -> John Ugnaught
Jai Falkor California -> Dalinar Aeryn Lannister
Shallan Yun Golubev -> Grint Kat Wayne
Ronin Julio Yusuf -> Rin Sim Morales
Paris Luke Nerfherder -> Jack Ryan Solo
Seltsa Tonya Sanz -> Seltsa Emma Roshka
Fatima Aphra Ramos -> Saanvi Tyrian Smith
Echo Zara GuYung -> Aphra Fisk Mizrachi
Galaria Anaya Levin -> Veebux Naruto Openheimer
Cho Jack O'Reilly -> Jennifer Vivenna Nerfherder
Gandalf Lakshi Kondo -> Eden Jack Ugnaught
Ali Ludo Halibut -> Avni Isabella Kendoshi
Xinia Xinyi Starsitter -> Septima Kat Feder
Shallan Ludo Wayne -> Echo Torol Dunbar
Sumayah Prisha Stormblessed -> Ajit Fatima Al-Ghul
Alister Jai Skylocke -> Maheen Galaria Stormblessed
Tao Yurt Hashimoto -> Cloud Abril Rodanza
Ziggurah HoosFoos Faheen -> Yun HoosFoos Geller
Ishna Emer Ramos -> Ishna Zelda Al-Ghul
Presley Oogex Chowdury -> Xinia Ronin Inez
ShaiLu Cellin Morales -> Cellin Cho Chowdury
Rahab Oogex Mizzrimor -> Corla Ollie Nyad
Abril Raven Sato -> Milan Verla GuYung
Jennifer Oogex Pratt -> Antonia Frodo Diego
Isabella Anaya Avraham -> Cloud Aeryn Morales
Umbra Galaria Leibniz -> Emilia Liv Memnon
Oogex Raven Zielinski -> Honoria Ziggurah Ibrahim
Gurn Sam Yeet -> Tullia Yash Evenstar
Sumayah Isabella Fuchs -> Yash Isolde Nerfherder
Alishba Vin Wan -> Ziggurah Saanvi Tehuacan
Xander ShaiLu Kent -> Kelsier Liv Gubler
John Ugnaught -> Geralt Foxx Hwang
Naruto Ziggurah Strife -> Zoe Abril Ibrahim
Lior Druzilla Schwetzer -> Prisha Ravi Rodriguez
Gurn Kat Earthsea -> Echo Torol Gerrit
Mehwish Yun Sokolov -> Rhaj Zarbo Jentry
Kale Milan Sol -> Midna Midna Sanz
Eva Tyrian Ogawa -> Presley Atreyu Occam
Fenix Meiling Evenstar -> Ashravan Ravi Earthsea
Wyrm Milo Ikeda -> Avni Ollie Miyagi
HoosFoos ShaiLu Sanz -> Isabella Anaya Avraham
Mehwish Sam Azlan -> Jareth Raven Schroeder
Kale Ulim Vought -> Jareth Falkor McDonald
Jack Tyrian Tehuacan -> Verla Mehwish Blanco
Lleshwi Zanzibrot -> Verden Jai Nesbit
Galaria Fatima Kerbochaurd -> Shrivan Corla Enchiridion
Bill Aphra Dreyfuss -> Atskuo Rhaj Nyad
Rahab Aphra Norton -> HoosFoos ShaiLu Sanz
Ganondorf ShaiLu Locke -> Ashravan Emilia Openheimer
Manuel Luke Kendoshi -> Anaya Link Al-Ghul
Ravi Eden Ugnaught -> John Avni Nakagawa
Apu Fisk Occam -> Zara Corla Inez
Ryan Aeryn Skywalker -> Zara Roroni Wu
Eva Leia Ogawa -> Yuanchen Vin Vought
Luke Wynn Masahiro -> Leona Verla Rockafeller
Ryu Quartz Vergebrand -> Jai Akio Rubio
Liv Vella Lurntz -> Isolde Ajit Westmore
Galaria Earnest Miyagi -> Neil Ximena Ibrahim
Tonya Jareth Sol -> Galaria Fatima Kerbochaurd
Midna Umbra Quetzelos -> Samus Aphra Ramos
Jai Avni Melbourne -> Ashravan Ashravan Newton
Link Aurora Kent -> Ryan Emma Cellish
Callum Vivenna Kholin -> Tullia Torol Jorn
Kelsier Zelda Halibut -> Luke Ravi Ogawa
HoosFoos Ganondorf Anderson -> Xinyi Roroni Gygax
Gandalf Ravi Earthsea -> Alishba Gwnivere Nightshade
Natasha Zara Wojciechowski -> Callum Roroni Chowdury
Tao Garter Eagle-Feather -> Yun Emma Chowdury
Meiling Xena Levin -> Ronin Garter Newton
Ulim Verla Kent -> Liv Xander Icthyon
Garter Liv Lestibourne -> Akio Atskuo Anderson
Julio Leona Vanderbilt -> Khan Peggy Uxima
Rahab Aeryn Dunbar -> Tao Yurt Hashimoto
Foxx Zant Chakma -> Jareth Septima Openheimer
Tonya Maheen Al-Ghul -> Yash Snimm Oneida
Raven Luke Tremonton -> Apu Tao Enchiridion
Ronin Vin Blanco -> Rahab Eden Vurnt
Ilena Druzilla Kritikos -> Gandalf Isabella Skywalker
Umbra Yggsila Inez -> Xena Areesha Fitzwilliam
Honoria ShaiLu Gubler -> Cloud Ilya Rasmussen
Seltsa Naruto Cellish -> Zoe John Santa-Cruz
Tullia Xander Trenton -> Isolde Ali O'Reilly
Zaraphel Sonia Elessar -> Verden Maria Jakzl
Eve Fatima Norton -> Eve Xinyi Dupont
Kelsier Galaria Miyagi -> Atskuo Xinyi Kondo
Apu Ryan Azlan -> Ryan Ishna Openheimer
Cassiopiea Vivenna Ashkenazi -> Veebux Milo Carnegie
Ronin Han Sol -> Zara Honoria Torres
Presley Jasnah Tremonton -> Snimm Seltsa Ahmed
Vortigern Emma Elessar -> Yggsila Atreyu Tehuacan
Ashravan Stormblessed -> Echo Zara GuYung
Jennifer Vivenna Nerfherder -> Akio Saanvi Torres
Llan Umbra Uxima -> Leia Paul Orbita
Ivanka Yun GuYung -> Leni Nora Lannister
Sim Falkor Magnusson -> Xinia Luke Rubio
Thane Midna Icthyon -> Septima Atreyu Dunbar
Jacob Ali Rubio -> Ximena Mehwish Schmidt
Gurn Ashravan Wu -> Vortigern Leona Orbita
Ashravan Sylphrena Fuchs -> Dalinar Webster Lannister
Jasnah Aeryn Anderson -> Ishna Zoe Vogelbaum
Korath Yuanchen O'Reilly -> Meiling Leni Wu
Natasha Honoria Kondo -> Rahab Artemis McDonald
Sam Seltsa Suarez -> Ximena Peggy Rodriguez
Snimm Aurora Mytaras -> Lyn Artemis Kent
Mehwish Zant Rax -> Jennifer Serene Eagle-Feather
Yuanchen Vin Vought -> Jai Tonya Inez
Ganondorf Aeryn Lestibourne -> Zarbo Manuel Ramos
Xander Alister Hishla -> Verden Lleshwi Guyaux
Yggsila Garter McCray -> Emer Presley Icthyon
Khan Alishba Cillia -> Han Lior Suarez
Verden Leona Tremonton -> Ilya Garter Lezrimond
Mehwish Galaria Yusuf -> Echo Torol Gerrit
Kelsier Yurt Centauri -> Jack Isabella Syushu
Ronin Julio Yusuf -> Milan Zara Hyprazia
Atskuo Tullia Schwetzer -> Leni Xander Kondo
Xena Ravi Hemonotz -> Webster Korath Ginfu
Maheen Rylan Kent -> Alister Ciri California
Jareth Raven Schroeder -> Galaria Areesha Zielinski
Aeryn Ludo Kendoshi -> Saanvi Emma Anderson
Artemis Areesha Jorn -> Leia Prisha Leibniz
Vortigern Krishna Openheimer -> Ivanka Yurt Murutsuma
Roroni Ziggurah Vogelbaum -> Ishna Aurora Eagle-Feather
Ivanka Valerian Jemishek -> Ashravan Emilia Openheimer
Xinyi Roroni Gygax -> Fisk Jai Blanco
Veebux Wynn Feder -> Aurora ShaiLu Lestibourne
Galaria Botax Sol -> Sim Valerian Schmidt
Corla Llan Nightshade -> Galaria Sam Kerbochaurd
Yggsila Naruto Sato -> Ziggurah Veebux Golubev
Avni HoosFoos Ramos -> Natasha Foxx Morales
Sylphrena Anaya Wu -> Atskuo Kelsier Kritikos
Akio Sylphrena Strife -> Falkor Naruto Daniels
Leni Tyrian Vinson -> Septima Atreyu Dunbar
Abril Lyn Zanzibrot -> Link Umbra Suarez
Umbra Yggsila Inez -> Prisha Abril Kondo
Verla Oogex Dryzt -> Tullia Dalinar Eagle-Feather
Rahab Prisha Skywalker -> Falkor Isabella Yoshida
Lior Valerian Stormblessed -> Ulrich Zara Pratt
Aeryn Ludo Kendoshi -> Isolde Bill Pleides
Drobyl Maheen Evenstar -> Jai Verla Trenton
Aeryn Rahab Vurnt -> Tullia Lleshwi Rockafeller
Ryan Isabella Hwang -> Aurora Isabella Hwang
Galaria Jai Jentry -> Verla Kelsier Jentry
Korath Cellin Yamada -> Leona Ulrich Lannister
Eden Yash Earthsea -> Ivanka Valerian Jemishek
Anaya Quartz Jemishek -> Milan Gandalf Syushu
Ximena Zara Dreyfuss -> Vella Peggy Yusuf
Ximena Jacob Pratt -> Jai Ravi Ikeda
Ilena Ali Jung -> Seltsa Naruto Cellish
Kelsier Zelda Halibut -> Gurn Sam Yeet
Nora Roroni Mejito -> Foxx Yezier Venli
Gurn Ivanka Murutsuma -> Isabella Verden Sentimere
Isabella Earnest Daniels -> Rin Wynn Idaho
Ishna Zoe Vogelbaum -> Emma Yezier Sentimere
Druzilla John Warplanter -> Bill Ulim Vergebrand
Fisk Garter Vogelbaum -> Webster Webster Oberron
Julio Fisk Vinson -> Cellin Luigi Hashimoto
Liv Leona Barnes -> Maria Krin Lopez
Eden Frodo Feder -> Xena Deepak Cheong
Galaria Jacob Kendoshi -> Julio Leona Vanderbilt
Ludo Guido Starsitter -> Cloud Sumayah Whitman
Maria Nora Torres -> Leni Maheen Venli
Umbra Xinyi Dryzt -> Serene Rhaj Ikeda
Maheen Maria Organa -> Quartz Areesha Tremonton
Khan Emilia Feder -> Atskuo Rhaj Nyad
Maria Nora Torres -> Xinia Callum Jung
Gwnivere Neil Lemont -> Emer Xinyi Trenton
HoosFoos Llan Mizzrimor -> Valerian Neil Vinson
Atskuo Kelsier Kritikos -> Apu Yurt Earthsea
Galaria Prisha Ikeda -> Yuanchen Krishna Hwang
Ilena Ryu Miyagi -> Yggsila Paul Oberron
Isolde Druzilla Mizrachi -> Link Aurora Kent
Jasnah Han Yeet -> Roroni Isabella Jung
Verla Bill Schroeder -> Wyrm Milo Ikeda
Cellin Ryan Idaho -> Saanvi Quartz Ogawa
Cassiopiea Emma Gerrit -> Kale Ulim Vought
Yuanchen Krishna Hwang -> Thane Ivanka Earthsea
Krin Buffalo Occam -> Prisha Emma Ford
Wynn Verla Lestibourne -> Korath Kat McMillan
Dalinar Sam Gubler -> Ziggurah Chiri-Chiri Wozniak
Grint Bill GuYung -> Ishna Veebux Quetzelos
Zaraphel Khan Hishla -> Avni Ajit Wu
Aeryn Xinyi Lurntz -> Corla Xander Fitzwilliam
Samus Aphra Ramos -> Leona Dalinar Wu
Meiling Ronin Rockafeller -> Jai Foxx Azlan
Fisk Yun Magnusson -> Yezier Emma Sato
Sim Eva Yoshida -> Nora Falkor Faheen
Vin Jack Ashkenazi -> Ximena Buffalo Serrano
Sreevatsava Cloud Lestibourne -> Ganondorf Yun Wayne
Sumayah Quartz Ahmed -> Alister Falkor Ashkenazi
Ajit Fatima Al-Ghul -> Atskuo Chiri-Chiri Kondo
Aeryn Rahab Vurnt -> Presley Jai Earthsea
Grint Bill GuYung -> Deepak Lyn Lezrimond
Isolde Gwnivere Ingersoll -> Cellin Ziggurah Norton
Neil Xinia Armitage -> Link Xianchu Inez
Fisk Krin Yeet -> Nora Dalinar Kent
Presley Ali Stormblessed -> Zara Xinia McDonald
Peggy Ulrich Wojciechowski -> Eva Vivenna Serrano
Ludo Guido Quetzelos -> Cloud Aeryn Morales
Honoria Anaya Murutsuma -> Serene Julio Fitzwilliam
John Ugnaught -> Milo Yurt Schmidt
Kaladin Shallan Openheimer -> Yezier Apu Cillia
Tonya Paris Memnon -> Ryu Apu Trenton
Luigi Vergebrand -> Zelda Jai Ingersoll
Xena Saanvi Nightshade -> Nora Dalinar Kent
Skar Ishna Fitzwilliam -> Torol Ulrich Jung
Serene Quartz Cheong -> Wyrm Lleshwi Gates
Presley Jai Earthsea -> Galaria Aeryn Lopez
Echo Kale Ford -> Aphra Antonia Nerfherder
Natasha Shrivan Carnegie -> Umbra Galaria Leibniz
Corla Fatima Ginfu -> Jasnah Han Yeet
Ximena Xinyi Newton -> Isolde Yurt Centauri
Verla Paris Pratt -> Grint Rhaj Armstrong
Manuel Ximena Zielinski -> Isabella Xena Magnusson
Gurn Korath Fandurin -> Akio Falkor Strife
Yun Seltsa Kendoshi -> Milo Korath Newton
Krishna Zara Oberron -> Akio Rhaj Strife
Leia Jennifer Jung -> Guido Corla Kritikos
Peggy Tao Hashimoto -> Tonya Rhaj Melbourne
Eva Drobyl Nerfherder -> Webster Honoria Yusuf
Falkor Zaraphel Dupont -> Yggsila Atreyu Tehuacan
Eva Lyn Yamada -> Rylan Ravi Perez
Galaria Botax Sol -> Garter Cassiopiea Rasmussen
Cassiopiea Luke Anderson -> Julio Prisha Hwang
Sreevatsava Valerian Armstrong -> Natasha Shrivan Carnegie
Korath Yuanchen Memnon -> Foxx Zara Dreyfuss
Skar Presley Ingersoll -> Peggy Ulrich Wojciechowski
Vella Krin Oberron -> Foxx Zant Chakma
Atreyu Shallan GuYung -> Eden Frodo Feder
Liv Llan Kritikos -> Vivenna Tullia Yoshida
Jai Guido Yusuf -> Presley Ganondorf Chakma
Galaria Saanvi Idaho -> Sumayah Yash Fitzwilliam
Sam Seltsa Suarez -> Drobyl Callum Miyagi
Ciri Roroni Atreides -> Grint Kat Suarez
Druzilla Avni Kholin -> Lyn Artemis Kent
Korath Deepak Ugnaught -> Foxx Dalinar Ramos
Shrivan Serene Ingersoll -> Lleshwi Verden Armstrong
Rahab Dalinar Daniels -> Sim Fatima Torval
Mehwish Oogex Starsitter -> Zoe Ludo Schmidt
Rhaj Lyn Magnusson -> Leia Jennifer Jung
Fenix Ajit Aetheryx -> Khan Peggy Uxima
Akio Maheen Rasmussen -> Isabella Milo Nakagawa
Sam Milo Lannister -> Isabella Saanvi Lezrimond
Ulrich Krin Fitzwilliam -> Nora Xinyi Wayne
Xena Aurora Cellish -> Roroni Xander Roshka
Garter Emilia Mizrachi -> Ludo Emma Stormblessed
Raven Sim Ashkenazi -> Lleshwi Ashravan Foorl
Lleshwi Jack Endo -> Honoria Alister Ford
Abril Raven Sato -> Botax Tyrian Wozniak
Oogex Jasnah Kondo -> Sumayah Prisha Stormblessed
Drobyl Galaria Schmidt -> Galaria Botax Sol
Julio Ajit Oneida -> Gandalf Cellin Solaris
Seltsa Eva Lezrimond -> Druzilla John Warplanter
Anaya Grint Torres -> Llan Lakshi Kwon
Eva Vivenna Serrano -> Buffalo Galaria Al-Ghul
Zoe Zelda Wu -> Isabella Paris Levin
Emer Echo Hwang -> Presley Lleshwi Chakma
Rin Wynn Idaho -> Luke Falkor Hashimoto
Link Lakshi Torval -> Samus Cassiopiea Kritikos
Vella Maheen Ibrahim -> Fisk Krin Yeet
Vin Manuel Diego -> Cassiopiea Cassiopiea Zanzibrot
Midna Atreyu Pratt -> Jareth Septima Openheimer
Cho Sim Daniels -> Mehwish Oogex Starsitter
Shrivan Meiling McDonald -> Valerian Wyrm Rubio
Julio Buffalo Evenstar -> Nora Botax GuYung
Zaraphel Tao Anderson -> Cloud Sumayah Whitman
Ryu Rhaj Duong -> Foxx Jareth Pratt
Verden Khan Ashkenazi -> Jack Tyrian Tehuacan
Anaya Grint Torres -> Jai Milan Jemishek
Atreyu Shallan Stormblessed -> Rahab Ulrich Faheen
Natasha Honoria Kondo -> Echo Antonia Blanco
Wyrm Ximena Jakzl -> Ajit Rin Schwetzer
Sumayah Meiling Evenstar -> Ajit Sim Stormblessed
Presley Gurn GuYung -> Drobyl Meiling Norton
Gandalf Gwnivere GuYung -> Akio Jennifer Mejito
Rhaj Deepak Rubio -> Sim Zant Mizzrimor
Thane Geralt Mizrachi -> Luke Wyrm Idaho
Ilena Kale Smith -> Tyrian Zant Torval
Honoria Naruto Dunbar -> Xinia Sonia Nyad
Ilya Roroni Wu -> Meiling Xianchu Garcia
Lyn Chiri-Chiri Vergebrand -> Apu HoosFoos Cheong
Gurn Sam Yeet -> Cassiopiea Lakshi Rubio
Jacob Tullia Rubio -> Ivanka Yezier GuYung
Emma Vivenna Enchiridion -> Sonia Apu Diego
Jareth Septima Openheimer -> Sylphrena Frodo Inez
Wyrm Ximena Jakzl -> John Antonia Wojciechowski
Echo Xena Rax -> Skar Cassiopiea Kerbochaurd
Emma Isabella Centauri -> Eva Skar Kent
Neil Vella Trenton -> Sreevatsava Thane Sokolov
Jareth Falkor McDonald -> Ryu Eden Feder
Akio GuYung -> Seltsa Thane Iyatil
Eve Geralt Trenton -> Cellin Sylphrena Kritikos
Vin Ulrich Azlan -> Emma Ali Mizrachi
Thane Geralt Mizrachi -> Liv Prisha Anderson
Ashravan Ashravan Newton -> Sumayah Khan Carnegie
HoosFoos Kat Openheimer -> Yggsila Peggy Ashkenazi
Vin Cho Jakzl -> Khan Ajit Magnusson
Ronin Garter Newton -> Yurt Ollie Kholin
Eve Nora Nyad -> Naruto Naruto Carnegie
Ryan Zelda Lannister -> Eve Jennifer Smith
HoosFoos Yezier Serrano -> Cloud Kaladin Kobayashi
Falkor Julio Armitage -> Jennifer Torres
Thane Aurora Hernandez -> Thane Ivanka Earthsea
Abril Deepak Magnusson -> Ludo Tao Occam
Rylan Sim Kent -> Meiling Xena Levin
Lleshwi Grint Fandurin -> Luigi Septima Leibniz
Krin Ximena Sentimere -> Shrivan Geralt Vogelbaum
Ivanka Tyrian Newton -> Presley Ravi Hemonotz
Paris Kat Torval -> Cloud Tullia Quetzelos
Cassiopiea Cassiopiea Zanzibrot -> Apu Korath Barnes
Rylan Verden Dreyfuss -> Leni Tyrian Vinson
Sim Atreyu Barnes -> Liv Vella Lurntz
Sumayah Thane Leibniz -> Sam Link California
Artemis Lleshwi Mytaras -> Isabella Paris Levin
Maria Aeryn Avraham -> Garter Jacob Ugnaught
Vivenna Thane Zanzibrot -> Cassiopiea Paris Yoshida
Ciri Wyrm Kerbochaurd -> Aeryn Kelsier Serrano
Ravi Presley Foorl -> Fatima Maria Ford
Valerian Guido Rodriguez -> Zarbo Webster Chowdury
Leni Nora Lannister -> Skar Ulim McMillan
Echo Eva Wu -> Fisk Ronin Blanco
Maria Eden Cellish -> Abril Serene Mephistopheles
Cellin Cho Chowdury -> Wynn Verla Lestibourne
Alister Ciri California -> Saanvi Grint Rubio
Yezier Prisha Idaho -> Kaladin Septima Fandurin
Wyrm Shrivan Nyad -> Yezier Alishba GuYung
Emer Maria Morales -> Artemis Yuanchen Hwang
Jai Tonya Inez -> Xianchu Maria Lestibourne
Zaraphel Manuel Lopez -> Alister Veebux Epenona
Dalinar Dalinar Faheen -> Cho Leia Kendoshi
Xianchu Maria Lestibourne -> Sam Yun Hashimoto
Buffalo Bill Rodriguez -> Xinia Gurn Cellish
Falkor Naruto Daniels -> Aphra Antonia Nerfherder
Aphra Ganondorf Kondo -> Zaraphel Isolde Locke
Paul Naruto Hemonotz -> Cho Jack O'Reilly
Vortigern Ashravan Epenona -> Leia Kale Serrano
Vella Wynn Earthsea -> Aphra McMillan
Julio Zarbo Leibniz -> Yurt Neil Ogawa
Verla Lior Murutsuma -> Roroni Isabella Jung
Isabella Saanvi Lezrimond -> Leona Dalinar Wu
Umbra Rylan Dostoyevsky -> Isabella Midna Wozniak
Nora Dalinar Kent -> Rhaj Milan Nerfherder
Jareth Isolde Evenstar -> Eve Vin Mytaras
Sam Ravi Gerrit -> Jennifer Ximena Zielinski
Fisk Verla Leibniz -> John Aphra Diego
Oogex Han Kruchev -> Rhaj Lyn Magnusson
Apu Kat Uxima -> Anaya Yezier Chowdury
Serene Isabella Elessar -> Xinia Isabella Stormblessed
Falkor Earnest Hyprazia -> Ilya Ganondorf Cheong
Maria Eden Foorl -> Presley Lleshwi Chakma
Bill Ulim Vergebrand -> Thane Xinyi Nerfherder
Luigi Septima Leibniz -> Buffalo Umbra Iyatil
Anaya Zant Oneida -> Lyn Paul Norton
Kelsier Liv Gubler -> ShaiLu Ximena Stormblessed
Rahab Prisha Skywalker -> Zara Eden Nakagawa
Vivenna Kelsier Lezrimond -> Druzilla Ollie Halibut
Quartz Tonya Mizrachi -> Emilia Rhaj Hishla
Korath Gwnivere Ugnaught -> Xinyi Tullia Ogawa
Ronin Emilia Wayne -> Ziggurah Fatima Newton
Verla Zarbo Icthyon -> Anaya Prisha Nakagawa
Luke Ivanka Organa -> Manuel Lakshi Lestibourne
Druzilla Sonia Skywalker -> Zaraphel Meiling Jakzl
Fisk Ilya Mephistopheles -> Emilia Paul Hashimoto
Paul Midna Al-Ghul -> Cellin Sylphrena Kritikos
Aphra Isabella Kendoshi -> Guido Buffalo Schroeder
Quartz Vin Icthyon -> Prisha Fisk Ginfu
Paris Vortigern Uxima -> Mehwish Yun Sokolov
Drobyl Luke Wan -> Roroni Vivenna Oneida
Zaraphel Webster Barnes -> Serene Isabella Elessar
Leona Dalinar Wu -> Wyrm Shrivan Nyad
Kat Ryan Mizrachi -> Raven Falkor Dryzt
Alishba Ravi Lezrimond -> Thane Jennifer PorSellik
Ronin ShaiLu Lestibourne -> Yurt Mehwish Solo
Khan Fisk Gubler -> Druzilla Guido Vurnt
Ronin Lior Mephistopheles -> Verla Zarbo Icthyon
Ximena Jasnah Organa -> Galaria Ronin Evenstar
Grint Buffalo Quetzelos -> Buffalo Alister Epenona
Quartz Tonya Mizrachi -> Jareth Fenix Elessar
Yash Sylphrena Rax -> Presley Jasnah Tremonton
Ulim Deepak Ashkenazi -> Manuel Ximena Zielinski
Jasnah Luke Ahmed -> Ali Mehwish Jorn
Webster Honoria Yusuf -> Kale Korath Lannister
Zaraphel Jasnah Lemont -> Paris Atreyu Gubler
Druzilla Sreevatsava Dunbar -> Gurn Ulrich Vogelbaum
Paris Atreyu Gubler -> Fatima Aeryn Trenton
Deepak Lleshwi Rodanza -> Krin Emma Torval
Cloud Abril Rodanza -> Jareth Mehwish Dostoyevsky
Tao Garter Eagle-Feather -> Ziggurah Zarbo Uxima
Saanvi Quartz Ogawa -> Ollie Septima Icthyon
Jasnah Guido Daniels -> Xinia Ganondorf Ford
Paul Umbra Yamada -> Dalinar Dalinar Faheen
Xinyi Ashravan Zanzibrot -> Avni Vin Elessar
Prisha Ravi Rodriguez -> Xander Kat Skylocke
Fatima Maria Ford -> Fisk Umbra GuYung
Earnest Eva Locke -> Corla Leni Iyatil
Cho Ravi Kent -> Buffalo Verden Sentimere
Avni Gwnivere Evenstar -> Ali Yurt Stormblessed
Vivenna Mehwish Wayne -> Samus Wyrm Eagle-Feather
Sam Ravi Gerrit -> Xena Garter Fandurin
Jacob Saanvi Solo -> Falkor Naruto Daniels
Grint Krin Miyagi -> Avni Alishba Sokolov
Callum Roroni Chowdury -> Gwnivere Snimm Locke
Vin Deepak Starsitter -> Sam Ollie Hyprazia
Dalinar Webster Lannister -> Alishba Gwnivere Nightshade
Fatima Aeryn Trenton -> Drobyl Nora Dupont
Ishna Ulrich Ramos -> Snimm Luigi Jorn
Umbra Presley Faheen -> Eden Jack Mizrachi
Wyrm Gwnivere Occam -> Naruto Serene Mizzrimor
John Umbra Dunbar -> Naruto Corla Melbourne
Kat Lleshwi Hernandez -> Alister Leni Mizzrimor
Eve Vin Mytaras -> Mehwish Yun Sokolov
Jasnah Jacob Epenona -> Llan Krin Hwang
Jennifer Torres -> Zant Bill Sanz
Midna Umbra Avraham -> Jasnah Avni Miyagi
Botax Areesha Magnusson -> Alishba Ravi Lezrimond
Ivanka Tyrian Newton -> Chiri-Chiri Xinia Oneida
Emma Yezier Sentimere -> Ollie Zelda Vurnt
Sylphrena Rahab Lannister -> Druzilla Krishna Ingersoll
Ajit Presley Sol -> Botax Vivenna Torres
Emma Emer Solo -> Leni Xena Duong
Paris Atreyu Gubler -> Oogex Lyn Petrovic
Grint Leona Carnegie -> Midna Sam Leibniz
Alister Falkor Ashkenazi -> Jack Ajit Wozniak
Eden Isabella Kerbochaurd -> Ryan Verden McCray
Naruto Samus Halibut -> Emma Honoria Cillia
Seltsa Isabella Yoshida -> Fisk Thane Newton
Serene Rhaj Ikeda -> Emer Sonia Halibut
Vortigern Ilya Idaho -> Paris Vortigern Uxima
Aurora Korath Zanzibrot -> Valerian Guido Rodriguez
Dalinar Xander Kondo -> Ishna Ulrich Ramos
Shallan Garter Queens -> Samus Lyn Solaris
Galaria Midna Lannister -> Geralt Galaria Warplanter
Akio Jennifer Mejito -> Ganondorf Grint Miyagi
Verden John Ramos -> Foxx Dalinar Ramos
Umbra Xinia Memnon -> Luigi Serene Locke
Naruto Eden Kent -> Xinyi Honoria Daniels
Xinyi Wyrm Stormblessed -> Zoe John Santa-Cruz
Deepak Chiri-Chiri Enchiridion -> Link Botax Kruchev
Saanvi Tyrian Smith -> Rahab Ulrich Faheen
Ryu Manuel Torres -> Nora Antonia Schwetzer
Isolde Gwnivere Ingersoll -> Ryan Zara Ford
Prisha Ilena Organa -> Vivenna Xena Nakagawa
ShaiLu Lyn Nerfherder -> Druzilla Tullia Kwon
Neil Korath Yamada -> Milan Leona Geller
Kat Ryan Mizrachi -> Ollie Torol Schwetzer
Samus Emilia Rasmussen -> Emma Emer Solo
Tyrian Areesha Dupont -> Rahab Dalinar Daniels
Fisk Falkor Vogelbaum -> Naruto Naruto Carnegie
Xinia Sonia Nyad -> Abril Gurn Petrovic
Midna Ilena Ahmed -> Jennifer Ajit Wozniak
Corla Paris Lopez -> Paris Kat Torval
Shallan Chiri-Chiri Rax -> Aeryn Chiri-Chiri Masahiro
Webster Liv Pleides -> Yggsila Paul Oberron
Jacob Tao McCray -> Ciri Xianchu Hyprazia
Galaria Kelsier Petrovic -> Eva Lyn Yamada
Jareth Zant Starsitter -> Rin Sim Ikeda
Apu Druzilla Venli -> Fatima Maria Ford
Frodo Natasha Dunbar -> Gandalf Ciri Vogelbaum
Atskuo Ryu Quetzelos -> Anaya Ollie Kholin
Jasnah Eve Sol -> Sumayah Apu Suarez
Lyn Corla Nyad -> Ximena Vivenna Kwon
Yggsila Paul Oberron -> Shallan Krishna Nyad
Jack Tyrian Tehuacan -> Kelsier Falkor Tehuacan
Meiling Emilia Enchiridion -> Prisha Ilena Organa
Sreevatsava Anaya Rasmussen -> Vortigern Ulrich Al-Ghul
Korath Lyn Daniels -> Aurora Buffalo Solaris
Gandalf Nora Hernandez -> Luke Falkor Hashimoto
Ludo Skar Icthyon -> Wynn Sonia Hemonotz
Guido Aphra Nyad -> Chiri-Chiri Sonia Ramos
Paris Ryu Miyagi -> Ulim Drobyl Westmore
Snimm Luigi Jorn -> Xander Xena Torres
Ryan Tullia Mizrachi -> Druzilla Guido Vurnt
Yurt Sam Dunbar -> Tyrian Ludo Vought
Saanvi Xena Cellish -> Lyn Fisk McCray
Maheen Maria Organa -> Sylphrena Paris Syushu
Ashravan Ravi Earthsea -> Vivenna Yuanchen Venli
Ulim Drobyl Westmore -> Eden Tao Lemont
Ryan Zara Ford -> Vivenna Xianchu Ikeda
Luigi Botax Skylocke -> Zant Bill Sanz
Presley Echo Levin -> Zara Zarbo Skywalker
Maria Xinia Mephistopheles -> Valerian Guido Rodriguez
Neil Ulim Openheimer -> Ryan Ilena Dreyfuss
Yurt Earnest Avraham -> Umbra Rylan Dostoyevsky
Isabella Verden Sentimere -> Grint Botax Hernandez
Naruto Vin Rodriguez -> Naruto Shallan Al-Ghul
Zelda Krin Starsitter -> Seltsa Eva Lezrimond
Zant Isolde Oneida -> Emilia Paul Hashimoto
Foxx Isabella Evenstar -> Eve Nora Nyad
Ronin Atreyu Wan -> Yggsila Yggsila Fitzwilliam
Thane Kat Melbourne -> Alister Umbra Levin
Gandalf Ciri Mejito -> Leni Corla Lannister
Rhaj Zarbo Jentry -> Zaraphel Vin Fandurin
Tao Jennifer Tehuacan -> Rin Ciri Rodriguez
Sylphrena Lyn Armstrong -> Jareth Falkor McDonald
Grint Kat Suarez -> Garter Ashravan Nesbit
Mehwish Tonya Gates -> Gwnivere Rylan Vinson
Xinia Ganondorf Ford -> Lyn Roroni Mytaras
Xinia Gurn Cellish -> Alishba Vin Atreides
Gurn Ulrich Vogelbaum -> Ajit Fatima Al-Ghul
Kale Ziggurah Wu -> Verla Quartz Nerfherder
Oogex Eve Wan -> Veebux Neil Schmidt
Mehwish Neil Schwetzer -> Xander Maheen Ramos
Liv Akio Yoshida -> Fisk Falkor Vogelbaum
Ajit Vella Melbourne -> Zelda Sim Vurnt
Atreyu Callum Rubio -> Sumayah Thane Leibniz
Foxx Dalinar Pratt -> Ivanka Yun GuYung
Quartz Yggsila Organa -> Gurn Ashravan Wu
Aeryn Shallan PorSellik -> Khan Cellin Yamada
Akio Botax Nesbit -> Krin Ximena Sentimere
Verla Luke Geller -> Roroni Chiri-Chiri Rax
HoosFoos Bill Nakagawa -> Ishna Rhaj Mizrachi
Milan Aeryn Volkov -> Jack Ulim Sokolov
Jasnah Yggsila Chowdury -> Cellin Gwnivere Cheong
Emer Xinyi Trenton -> Lyn Avni Dupont
Paul Krishna Al-Ghul -> Tyrian Ryu Quetzelos
Ciri Mehwish Fuchs -> Maheen Quartz Evenstar
Krin Rylan Halibut -> Shallan Garter Queens
Naruto Rhaj Mejito -> Ciri Roroni Atreides
Tao Jennifer Tehuacan -> Anaya Ollie Endo
Isolde Yurt Centauri -> Leia Luigi Nightshade
Lyn Jareth Rax -> Lyn Shrivan Geller
Vivenna Nora Ginfu -> Thane Aurora Hernandez
Guido Krin Mejito -> Mehwish Zant Rax
Lyn Artemis Kent -> Ronin Garter Newton
Shrivan Geralt Vogelbaum -> Sreevatsava Avni Solaris
Krishna Zara Oberron -> Umbra Ashravan Torval
Rin Sim Ikeda -> Xena Lleshwi Murutsuma
Shrivan Verla Orbita -> Aurora Prisha Lurntz
Veebux Isolde Ikeda -> Raven Chiri-Chiri Ramos
Nora Ulrich Evenstar -> Ivanka Verden Locke
Areesha Emma Zielinski -> Neil Ulim Openheimer
Ulrich Zara Pratt -> Samus Alister Jakzl
Nora Botax GuYung -> Jacob Dalinar Chakma
Presley Ganondorf Chakma -> Botax Garter Torres
Eva Ilena Kholin -> Chiri-Chiri Presley Torres
Lleshwi Shallan Orbita -> Thane Midna Icthyon
Sreevatsava Thane Sokolov -> Lyn Roroni Mytaras
Honoria Ziggurah Ibrahim -> Jasnah Leia Lannister
Alister Falkor Ashkenazi -> Sumayah Sam Vanderbilt
Maheen Jareth Faheen -> Xinyi Ashravan Zanzibrot
Link Ivanka Quetzelos -> Quartz Yggsila Organa
Ravi Presley Wozniak -> Corla Fisk Avraham
Saanvi Khan Iyatil -> Vella Wyrm Santa-Cruz
Sim Falkor Magnusson -> Webster Nora Nesbit
Corla Leni Iyatil -> Luke Wynn Masahiro
Peggy Ulrich Wojciechowski -> Torol HoosFoos Foorl
Ryu Isolde Cillia -> Sreevatsava Cloud Lestibourne
Korath Kat McMillan -> Jareth Presley Armstrong
Grint Rhaj Armstrong -> Cellin Veebux Schroeder
Atreyu Antonia Lemont -> Ryu Zara Yusuf
Aphra Wyrm Armitage -> Vortigern Aeryn Kerbochaurd
Veebux Neil Schmidt -> Jack Ludo Inez
Chiri-Chiri Vin Lurntz -> Falkor Manuel Vinson
Anaya Zant Oneida -> Gwnivere Guido Armitage
Zelda Krishna Occam -> Link Kaladin Kwon
Verden Khan Ashkenazi -> Vin Cho Jakzl
Roroni Buffalo Centauri -> Corla Llan Nightshade
Abril Botax Kobayashi -> Veebux Sumayah Rodriguez
Honoria Ganondorf Lurntz -> Maheen Galaria Stormblessed
Fenix Leona Dreyfuss -> Leia Ronin Rodanza
Luke Lyn Azlan -> Yurt Neil Ogawa
Sylphrena Wynn Zielinski -> Geralt Anaya Roshka
Cassiopiea Cho Magnusson -> Vortigern Jacob Pratt
Ludo Leona Hashimoto -> Rin Zara Kendoshi
Lleshwi Verden Armstrong -> Rin Xianchu O'Reilly
Krin Emma Torval -> Luke Wynn Masahiro
Deepak Fisk Westmore -> Echo Julio Levin
Luke Ravi Ogawa -> Julio Vin Duong
Druzilla John Orbita -> Ashravan Ulim Torval
Manuel Yash Nyad -> Falkor Earnest Hyprazia
Jai Verla Trenton -> Jasnah Eve Sol
Kat Alishba Serrano -> Midna Zoe Gygax
Ciri Zelda Orbita -> Raven Luke Tremonton
Sim Fatima Torval -> ShaiLu Prisha Hernandez
Anaya Ziggurah Orbita -> Ali Yurt Hwang
Zant Ximena Oberron -> Falkor Rin Vergebrand
Atskuo Gurn Icthyon -> Ximena Fenix Yamada
Meiling Ilena Skylocke -> Botax Ilena Murutsuma
Maheen Quartz Evenstar -> Aphra Cassiopiea Mizrachi
Xianchu Fatima Sanz -> Aeryn Xinyi Lurntz
Krishna Leni Ugnaught -> Tonya Isolde Syushu
Llan Tonya McMillan -> Zara Rylan Faheen
Ilya Ollie Chowdury -> Sim Falkor Magnusson
Zoe Ludo Schmidt -> Yurt Grint Mizrachi
Verla Ollie Lemont -> Link Ivanka Quetzelos
Vivenna Neil Vanderbilt -> Shrivan Corla Enchiridion
Callum Shallan Blanco -> Drobyl Atskuo Nakagawa
Natasha Wyrm Jakzl -> Verla Lior Murutsuma
Cloud Isolde Mytaras -> Sonia Krin Petrovic
Shrivan Jennifer Masahiro -> Atreyu Shallan Stormblessed
Oogex Khan Armitage -> Aeryn Rahab Vurnt
Cloud Mephistopheles -> Serene Korath Sol
Ivanka Yun GuYung -> Zaraphel Webster Barnes
Sim Skar Garcia -> Emma Rhaj Kruchev
Peggy Prisha Vanderbilt -> Prisha Naruto Blanco
Drobyl Galaria Schmidt -> Aeryn Shallan PorSellik
Antonia Ulim Queens -> Ashravan Sylphrena Fuchs
Manuel Thane Nyad -> Geralt Anaya Roshka
Seltsa Isabella Yoshida -> Cho Ziggurah Zielinski
Tullia Icthyon -> Avni Seltsa Masahiro
Krin Eve Westmore -> Leia Ronin Rodanza
Serene Ryan Centauri -> Rin Mehwish Xi
Xander Alister Hishla -> Fatima Roroni Skylocke
Alister Jareth Sato -> Bill Zelda Armitage
Yurt Grint Mizrachi -> Shrivan Geralt Vogelbaum
Link Rin Cheong -> Luigi Ronin Mizzrimor
Druzilla Guido Vurnt -> Emer Echo Hwang
Avni Cho Gerrit -> Kaladin Corla Vogelbaum
Sylphrena Fatima Zanzibrot -> Eva Drobyl Nerfherder
Serene Shrivan Nightshade -> Anaya Zant Oneida
Seltsa Verla Murutsuma -> Naruto Roroni Occam
HoosFoos Eve Kobayashi -> HoosFoos ShaiLu Sanz
Ludo Yuanchen Perez -> Peggy Cellin Strife
Vortigern Webster Stormblessed -> Ravi Eden Ugnaught
Tonya Serene Santa-Cruz -> Antonia Emer Diego
Buffalo Verden Sentimere -> Garter Eve Mejito
Frodo Ulim Rax -> Lleshwi Shallan Orbita
Verla Zoe Sokolov -> Foxx Zant Chakma
Raven Rylan Ikeda -> John Emer Blanco
Zara Yurt Westmore -> Rahab Antonia Suarez
Ulrich Manuel Faheen -> Han Nora Nesbit
Mehwish Garter Santa-Cruz -> Neil Armstrong
Luigi Tullia Rockafeller -> Vortigern Ulrich Al-Ghul
Jacob Umbra Yeet -> Fisk Umbra GuYung
Jennifer Cassiopiea McDonald -> Ulrich Krin Fitzwilliam
Cho Maheen Barnes -> Krin Alishba Inez
Luke ShaiLu Mephistopheles -> Druzilla Sonia Skywalker
Geralt Galaria Warplanter -> Umbra Presley Faheen
Sonia Yash Anderson -> Paul Ziggurah Wozniak
Frodo Xinyi Schroeder -> Kelsier Zelda Halibut
Roroni Vivenna Oneida -> Eve Vin Mytaras
Isolde Ziggurah Ahmed -> Yuanchen Krishna Hwang
Buffalo Galaria Al-Ghul -> Yurt Gwnivere Schroeder
Sumayah Meiling Evenstar -> Kale Ziggurah Wu
Septima Isabella Azlan -> Link Aurora Kent
Valerian Emma Perez -> Natasha Foxx Morales
Garter Geralt Yoshida -> Ivanka Serene Lemont
Isolde Tao Pratt -> Leni Vortigern Fuchs
Presley Oogex Chowdury -> Shrivan Snimm Azlan
Cassiopiea Roroni Golubev -> Sreevatsava Webster Tehuacan
Leona Honoria Westmore -> Presley Rahab Suarez
Yuanchen Vin Vought -> Shrivan Sylphrena Stormblessed
Buffalo Umbra Iyatil -> Umbra Rhaj McDonald
Botax Garter Torres -> Kale Korath Lannister
Ryan Emma Cellish -> Apu Korath Barnes
Ajit Kaladin Solo -> Isabella Midna Wozniak
Fenix Tonya O'Reilly -> Apu Peggy Lezrimond
Aeryn Shallan PorSellik -> Wynn Ishna Rax
Eden Meiling Ugnaught -> Maria Meiling Norton
Vin Verden Yusuf -> Yurt Sam Dunbar
Meiling Fenix Perez -> Emilia Septima Feder
Fisk Ronin Blanco -> Leia Jennifer Kerbochaurd
Artemis Jack Petrovic -> Luke Druzilla Quetzelos
Krishna Link Lemont -> Luigi Serene Locke
Isabella Milo Nakagawa -> Ilena Llan Ibrahim
Leni Hyprazia -> Atreyu Shallan GuYung
Liv Webster Kerbochaurd -> Ali Mehwish Jorn
Maheen Tao Golubev -> Julio Leona Vanderbilt
Gurn Krin Faheen -> Grint Guido Sato
Sumayah Areesha Skylocke -> Tullia Abril Yoshida
Ivanka Yezier GuYung -> Isolde Ajit Westmore
Fatima Lior Oneida -> Leona Gurn Uxima
Xander Thane Dryzt -> Apu Deepak Hemonotz
Echo Julio Elessar -> Grint Kat Suarez
Deepak Lyn Lezrimond -> Ashravan Ajit Santa-Cruz
Sonia Apu Diego -> Verla Zarbo Icthyon
Verden Jai Nesbit -> Buffalo Ziggurah Armstrong
Tao Galaria Dunbar -> Wyrm Tao Newton
Korath Ravi Syushu -> Sreevatsava Frodo Lestibourne
Cloud Mephistopheles -> Leia Antonia Kerbochaurd
Verla Ollie Lemont -> Aurora Gandalf Sol
Cloud Maheen Cillia -> Ludo Yuanchen Perez
Roroni Buffalo Centauri -> Cassiopiea Manuel Avraham
Gandalf Lakshi Kondo -> Ollie Meiling Vogelbaum
Zoe John Santa-Cruz -> Krishna Sumayah O'Reilly
Xinia Roroni Santa-Cruz -> Fatima Lior Oneida
Manuel Prisha Whitman -> Lakshi Druzilla Hyprazia
Gandalf Avni Mephistopheles -> Ivanka Valerian Jemishek
Xinyi Neil Dostoyevsky -> Sumayah Prisha Stormblessed
Link Kaladin Kwon -> Veebux Skar Vogelbaum
Aurora Buffalo Solaris -> Emer Ulim Westmore
HoosFoos Ganondorf Anderson -> Emma Prisha Evenstar
Yezier Apu Cillia -> Jai Falkor California
Sam Link California -> Verden Wynn Ibrahim
Aurora Alishba Schmidt -> Sreevatsava Cho Guyaux
Luke Cellin Gubler -> Anaya Quartz Jemishek
Yurt Ludo Endo -> Lakshi Roroni Westmore
Rin Cho Ingersoll -> Druzilla Sonia Skywalker
Falkor Rin Vergebrand -> Ishna Jareth Sato
Gandalf Cellin Solaris -> Seltsa Jacob Centauri
Grint Buffalo Quetzelos -> Isolde Sylphrena Kobayashi
Isabella Jacob Vanderbilt -> Paul Earnest Vergebrand
Sreevatsava Webster Tehuacan -> Milo Han Hernandez
Shallan Krishna Nyad -> Gandalf Nora Hernandez
Sumayah Isabella Fuchs -> Link Wyrm Jakzl
Torol HoosFoos Foorl -> Raven Fatima Masahiro
Xinyi Ashravan Schmidt -> Meiling Ilena Skylocke
Isolde Ajit Westmore -> HoosFoos Yezier Serrano
Cassiopiea Manuel Avraham -> Sumayah Jacob Uxima
Ajit Vin Sokolov -> Natasha Ryan Atreides
Jasnah Sam Suarez -> Jasnah Aphra Kruchev
Garter Jacob Ugnaught -> Oogex Raven Zielinski
Gwnivere Naruto Ashkenazi -> Druzilla John Orbita
Korath Falkor Solaris -> Kelsier Yurt Centauri
HoosFoos Vella Miyagi -> Ulrich Emilia Vogelbaum
Isabella Verden Sentimere -> Apu Kat Uxima
Shallan Ilya Ashkenazi -> Gwnivere Frodo Kruchev
Ziggurah Zant Epenona -> Luke Ryu Murutsuma
Fatima Ajit Rockafeller -> Rhaj Honoria Roshka
Ali Druzilla Miyagi -> Jacob Umbra Yeet
Tonya Paris Memnon -> Ashravan Snimm Wu
Cellin Emer Melbourne -> Cellin Cho Chowdury
Sumayah Frodo Schwetzer -> Akio Atskuo Anderson
Meiling Fenix Perez -> Xinyi Gurn Guyaux
Galaria Earnest Petrovic -> Xander Alister Hishla
Naruto Roroni Occam -> Sonia Ilena Gates
Jack Isabella Syushu -> Paris Vivenna Murutsuma
Lyn Chiri-Chiri Vergebrand -> Abril Lyn Zanzibrot
Yurt Umbra Lemont -> Dalinar Emer Rockafeller
Shrivan Serene Ingersoll -> Verla Luke Geller
Tullia Atreyu Fandurin -> Manuel Leia Zheng
Wynn Sonia Hemonotz -> Mehwish Deepak Lemont
Bill Xinyi Ginfu -> John Presley Ogawa
Avni Seltsa Petrovic -> Maheen Xena Yeet
Llan Krin Hwang -> Isolde Galaria Rodanza
Paris Luke Nerfherder -> Guido Saanvi McMillan
Umbra Xinyi Dryzt -> Liv Leona Barnes
Alister Yun Yeet -> Sonia Yash Anderson
Areesha Ronin Jemishek -> Ximena Jacob Pratt
Naruto Yezier Armitage -> Callum Atreyu Rockafeller
Liv Emer Vergebrand -> Saanvi Xena Cellish
Galaria Ronin Evenstar -> Milan Aphra Wojciechowski
Oogex Khan Armitage -> Umbra Xinyi Dryzt
Emer Atskuo Wojciechowski -> Raven Druzilla Ford
Ali Mehwish Jorn -> Jacob Avni Eagle-Feather
Veebux Isolde Ikeda -> Echo Xena Rax
Thane Jennifer PorSellik -> Gurn Gandalf Ogawa
Akio Krin Yoshida -> Ravi Umbra Zheng
Callum Vivenna Kholin -> Areesha Isabella Warplanter
Yun Ajit Organa -> Fenix Ajit Aetheryx
Galaria Jacob Vinson -> Zant Xianchu Ramos
Sonia Jai Tehuacan -> Jai Skar Azlan
Ivanka Verden Locke -> Jennifer Vivenna Nerfherder
Jacob Neil Pratt -> Mehwish Zant Rax
Guido Aphra Nyad -> Galaria Manuel Iyatil
Oogex Julio Jemishek -> Ilya Frodo Mephistopheles
Luigi Serene Locke -> Gandalf Ravi Earthsea
Prisha Fisk Ginfu -> Link Rin Cheong
Yurt Sam Dunbar -> Grint Buffalo Quetzelos
Yurt Ollie Kholin -> Yezier Alishba GuYung
Vella Gurn Schwetzer -> Quartz Oogex Starsitter
Shallan Mehwish Locke -> Atskuo Tullia Schwetzer
Lior Valerian Stormblessed -> Midna Umbra Avraham
Sonia Ilena Gates -> Jasnah Rahab Leibniz
Julio Fisk Vinson -> Xinyi Xena Ashkenazi
Quartz Link Lestibourne -> Krin Emma Torval
Sylphrena Anaya Wu -> Yurt Cloud PorSellik
Botax Alishba Ahmed -> Manuel Apu Serrano
Emma Prisha Evenstar -> Corla Paris Lopez
Eva Lyn Yamada -> Leni Emma Vogelbaum
Jennifer Ximena Jentry -> Ivanka Verden Locke
Aurora Lyn Geller -> Umbra Presley Faheen
Grint HoosFoos Queens -> Abril Rahab Rasmussen
Link Callum Dryzt -> Echo Julio Elessar
Naruto Vin Rodriguez -> Roroni Skar Jemishek
Verden Maria Jakzl -> Frodo Lyn Epenona
Manuel Leia Zheng -> Ximena Zara Dreyfuss
Chiri-Chiri Kaladin McMillan -> Aurora Lyn Geller
Jai Aurora PorSellik -> Vin Manuel Diego
Raven Fatima Masahiro -> Foxx Jack Inez
Drobyl Zara California -> Zoe Ludo Schmidt
Apu Peggy Lezrimond -> Jasnah Lyn Ogawa
Kat Emilia Wozniak -> Gwnivere Frodo Kruchev
Xianchu Abril Roshka -> Ronin Atreyu Wan
Leia Jennifer Jung -> Cassiopiea Gwnivere Enchiridion
Leia Kale Serrano -> Ashravan Stormblessed
Korath Shallan Nesbit -> Aeryn Chiri-Chiri Masahiro
Yuanchen Ashravan Lemont -> Buffalo Sreevatsava Yusuf
Gandalf Zaraphel Jemishek -> Isolde Tao Pratt
Avni Seltsa Masahiro -> Ziggurah Veebux Golubev
Milan Eva Sokolov -> Krishna Wyrm Fitzwilliam
Avni Isabella Kendoshi -> Verla Ivanka Rodriguez
Ximena Eden Epenona -> Shallan Ilya Ashkenazi
Link Kaladin Kwon -> Ulim Serene Newton
Yun Emma Chowdury -> Shallan Mehwish Locke
Midna Umbra Avraham -> Callum Khan Ibrahim
Ciri Peggy Solo -> Ciri Xianchu Hyprazia
Mehwish Garter Santa-Cruz -> Isolde Gwnivere Ingersoll
Ludo Tao Occam -> Jennifer Lyn Icthyon
Emilia Areesha Earthsea -> Peggy Tao Hashimoto
Xinyi Gurn Guyaux -> Lior Druzilla Schwetzer
Meiling Sim Murutsuma -> Sylphrena Rahab Lannister
Galaria Earnest Petrovic -> Emma Geralt Starsitter
Abril Shallan Mejito -> Tonya Paris Memnon
Foxx Ishna Leibniz -> Meiling Emilia Enchiridion
Callum Sonia Dreyfuss -> Lyn Chiri-Chiri Vergebrand
Vella Geralt Vought -> Ulim Saanvi Golubev
Foxx Jareth Pratt -> Webster Korath Ginfu
Shallan Eve California -> Quartz Tyrian Openheimer
Quartz Oogex Starsitter -> Samus Kaladin Barnes
Xianchu Fatima Sanz -> Foxx Dalinar Pratt
Xander Thane Dryzt -> Grint Yun Cellish
Eva Ilena Kholin -> Maheen Jareth Faheen
Frodo Ashravan Sato -> Prisha Presley Volkov
Artemis Midna Schmidt -> Link Lakshi Torval
Yuanchen Apu Miyagi -> Ronin Julio Yusuf
Naruto Sim Openheimer -> Avni Frodo Norton
Vortigern Han Dupont -> Ryan Aeryn Skywalker
Shrivan Ryu Ginfu -> Drobyl Luke Wan
Jennifer Falkor Feder -> HoosFoos Chiri-Chiri Nyad
Jareth Ashravan Mizrachi -> Sylphrena Lyn Armstrong
Drobyl Maheen Evenstar -> Xianchu Fatima Sanz
Ciri Meiling Gubler -> Zoe Vortigern Wojciechowski
Falkor Earnest Hyprazia -> Emer Apu Cellish
Ciri Meiling Gubler -> Botax Sim Rodanza
Samus Lyn Solaris -> Callum Midna Endo
Bill Xinyi Morales -> Isolde Krin Venli
Lyn Paul Norton -> Honoria Naruto Dunbar
Midna Thane Gubler -> Atreyu Antonia Lemont
Dalinar Xander Kondo -> Vin Verden Yusuf
Ollie Wyrm Lannister -> Korath Yuanchen Memnon
Anaya Ollie Kholin -> Webster Honoria Yusuf
Julio Emer Masahiro -> Galaria Kelsier Petrovic
Botax Ilena Murutsuma -> Thane Xinyi Nerfherder
Xinia Xinyi Starsitter -> Nora Peggy Epenona
Lyn Eva Occam -> Sonia Quartz Pleides
Torol Ulrich Jung -> Midna Isabella Fitzwilliam
Jasnah Eve Sol -> Xinia Roroni Santa-Cruz
Buffalo Galaria Al-Ghul -> Snimm Dalinar Strife
Link Botax Kruchev -> Ganondorf Yun Wayne
Alister Abril Xi -> Vella Ravi Iyatil
Jasnah Leia Lannister -> Ziggurah Khan Kholin
Vortigern Webster Stormblessed -> Chiri-Chiri Deepak Skywalker
Torol Akio Atreides -> Leia Paul Orbita
Cho Leia Kendoshi -> Yurt Sylphrena Mizrachi
Veebux Yash Evenstar -> Xianchu Zoe Schmidt
Grint Serene Newton -> Cho Jack O'Reilly
Ulrich Krin Enchiridion -> Callum Shallan McCray
Sonia Ajit Icthyon -> Grint Jai Lezrimond
Ryan Ilena Dreyfuss -> Dalinar Lior Ashkenazi
Zoe Vortigern Wojciechowski -> Dalinar Fenix Ashkenazi
Xinia Ximena Lestibourne -> Saanvi Torol Perez
Ashravan Verla Hernandez -> Avni Isabella Kendoshi
Fisk Jai Blanco -> Serene Quartz Cheong
Ulrich Jai Idaho -> Ollie Liv Westmore
Zaraphel Vin Fandurin -> Neil Armstrong
Milan Jack Nakagawa -> Ciri Roroni Atreides
Guido Areesha Norton -> Earnest Ravi Starsitter
Saanvi Gwnivere Azlan -> Drobyl Zara California
Tonya Zaraphel Venli -> Sreevatsava Tullia Rodriguez
Lyn Avni Dupont -> Xander ShaiLu Kent
Link Ajit Santa-Cruz -> Sylphrena Wynn Zielinski
Ollie Saanvi Nerfherder -> Sam Seltsa Suarez
Ludo Yuanchen Perez -> Valerian Ivanka Lannister
Leia Valerian Whitman -> Alister Abril Xi
Cellin Ziggurah Norton -> Kat Ryan Mizrachi
Fisk Garter Vogelbaum -> Ravi Veebux McMillan
Webster Emma Ugnaught -> Luigi Botax Skylocke
Milo Webster Armitage -> Vin Oogex Oberron
Ronin Kale Gerrit -> Lior Cho Dreyfuss
Falkor Jacob Murutsuma -> Botax Garter Torres
Gurn Ivanka Murutsuma -> Cloud Ulrich Lezrimond
Milo Korath Newton -> Galaria Jacob Vinson
Xena Ryan Lestibourne -> Ronin Atreyu Wan
Ravi Umbra Zheng -> Apu Tao Enchiridion
Ilya Paul California -> Callum Naruto Mephistopheles
Zelda Llan Elessar -> Saanvi Xena Cellish
Gwnivere Guido Armitage -> Maheen Quartz Leibniz
Verla John Kendoshi -> Verden Jai Nesbit
Isolde Rylan Lezrimond -> Guido Sonia Gubler
Apu Milo Kerbochaurd -> Sreevatsava Tullia Rodriguez
Avni Seltsa Petrovic -> Mehwish Sim Lopez
Eve Xinyi Diego -> Sam HoosFoos Guyaux
Cloud Aeryn Morales -> Julio Buffalo Evenstar
Paul Umbra Yamada -> Verden Khan Ashkenazi
Yash Sreevatsava Ogawa -> Julio Ajit Oneida
Skar Ulim McMillan -> Tyrian Kale Volkov
Tao Callum Volkov -> Gwnivere Buffalo Icthyon
Peggy Cellin Strife -> Yun Seltsa Kendoshi
Link Xianchu Inez -> Fisk Wyrm Dupont
Abril Shallan Mejito -> Jennifer Falkor Feder
Zoe Vin Kondo -> Kelsier Yurt Centauri
Akio Valerian Rockafeller -> Korath Shallan Nesbit
Emma Ali Mizrachi -> Corla Natasha Serrano
Akio Atskuo Anderson -> Eden Jack Mizrachi
Zelda Verla McMillan -> Aurora Lyn Geller
Julio Emer Masahiro -> Meiling Sim Murutsuma
Milo Verla Ginfu -> Alister Ciri California
Ravi Dalinar Zheng -> Seltsa Septima Dryzt
Sumayah Apu Suarez -> Grint HoosFoos Queens
Garter Emilia Mizrachi -> Lleshwi Sam Sato
Cassiopiea Gwnivere Enchiridion -> Ulrich Torol California
Eve Fatima Norton -> Ishna Lior Organa
Xander Maheen Ramos -> Ali Yurt Stormblessed
Ulrich Alister Norton -> Midna Zoe Gygax
Naruto Sim Openheimer -> Tullia Oogex Kwon
Ulim Leona Rodanza -> Rahab Prisha Skywalker
Jai Tonya Inez -> Isabella Jacob Vanderbilt
Ali Honoria Kerbochaurd -> Verla Vella Daniels
Yurt Ludo Endo -> Buffalo Buffalo Earthsea
Ilya Quartz Daniels -> Neil Armstrong
Paul Leia Suarez -> Dalinar Tao Yusuf
Xander Xena Torres -> Anaya Kelsier Icthyon
Aurora ShaiLu Lestibourne -> Verla Oogex Dryzt
Shrivan Ulrich Quetzelos -> Khan Fisk Gubler
Garter Jacob Ugnaught -> Buffalo Vivenna Chowdury
Leona Honoria Westmore -> Verla Sylphrena Barnes
ShaiLu Sylphrena Faheen -> Jasnah Han Yeet
Vivenna Krin Oberron -> Cellin Veebux Schroeder
Tao Galaria Dunbar -> Yuanchen Milo Fuchs
Cloud Sumayah Whitman -> Zelda Krin Starsitter
Ziggurah Zarbo Uxima -> Manuel Yash Nyad
Xena Krin Zanzibrot -> Eden Echo Pratt
Oogex Raven Zielinski -> Vortigern Ashravan Epenona
Tao Callum Volkov -> Vella Gurn Schwetzer
Ronin Kale Gerrit -> Gurn Liv Vanderbilt
Frodo Ashravan Sato -> Earnest Krin PorSellik
Sumayah Areesha Skylocke -> Umbra Yggsila Inez
Zant Bill Sanz -> Eva Tyrian Ogawa
Jareth Kale Vanderbilt -> Luke Ryu Murutsuma
Saanvi Raven Geller -> Alister Leni Mizzrimor
Natasha Maheen Epenona -> Khan Fisk Gubler
Geralt Emma Vurnt -> Akio GuYung
Krin Jai Suarez -> Xinia Ashravan Starsitter
Ulrich Earnest Carnegie -> Anaya Ollie Kholin
Septima Atreyu Dunbar -> Botax Ilena Murutsuma
Eden Isabella Kerbochaurd -> Raven Sim Ashkenazi
Thane Xinyi Nerfherder -> Vivenna Xena Nakagawa
Skar Oogex Westmore -> Ryan Tullia Mizrachi
Artemis Zelda Lemont -> Alister Yun Yeet
Neil Ximena Ibrahim -> Korath Falkor Solaris
Zelda Jai Ingersoll -> Zoe Vin Kondo
Earnest Yezier Yoshida -> Sam Korath Jentry
Oogex Lyn Petrovic -> Cellin Rahab Guyaux
Ivanka Yurt Murutsuma -> Alister Umbra Levin
Yash Deepak Starsitter -> Xinyi Wyrm Stormblessed
Honoria Naruto Dunbar -> HoosFoos Vella Miyagi
Atskuo Rhaj Nyad -> Leona Verla Rockafeller
Gurn Korath Fandurin -> Deepak Vivenna Mizzrimor
Ilena Aurora Jakzl -> Zara Xinia McDonald
Ishna Zoe Vogelbaum -> Midna Thane Gubler
Dalinar Naruto Dryzt -> Serene HoosFoos Icthyon
Rahab Artemis McDonald -> Vin Ryan Sol
Jareth Antonia Wozniak -> Rahab Naruto Dostoyevsky
Liv Prisha Anderson -> Seltsa Isabella Yoshida
Ilya Rahab McDonald -> Julio Grint Magnusson
Ajit Samus Anderson -> Sam Atskuo Guyaux
Isabella Xena Magnusson -> Lyn Jasnah Vought
Yggsila Emer Wojciechowski -> Ganondorf ShaiLu Locke
Link Isolde Roshka -> Sonia Jai Tehuacan
Apu Tao Enchiridion -> Druzilla John Warplanter
Link Eva Rubio -> Paris Vivenna Murutsuma
Zaraphel Webster Barnes -> Aeryn Ludo Kendoshi
Eva Vivenna Serrano -> Kelsier Galaria Miyagi
Snimm Seltsa Ahmed -> Cellin Ryan Idaho
Veebux Natasha Melbourne -> Sonia Krin Petrovic
Manuel Lakshi Lestibourne -> Dalinar Webster Lannister
Sreevatsava Avni Solaris -> Prisha Ilena Organa
Emer Maria Morales -> Xinia Sreevatsava Tehuacan
Bill Xinyi Ginfu -> Yash Sylphrena Rax
Ryan Verden McCray -> Drobyl Alister Dupont
Oogex Eve Gerrit -> Seltsa Naruto Cellish
Veebux Kelsier Schmidt -> Ishna Druzilla Ginfu
Xinia Ronin Inez -> Areesha Echo Rodanza
Vivenna Kat Centauri -> Wynn Sonia Hemonotz
Callum Veebux Wu -> Jasnah Aphra Kruchev
Cloud Gwnivere Eagle-Feather -> Atreyu Shallan Stormblessed
Garter Sumayah Gates -> Jareth Tonya Aetheryx
Saanvi Grint Rubio -> Yezier Alister Hwang
Ronin Frodo Dupont -> Manuel Apu Serrano
Peggy Dalinar Smith -> Veebux HoosFoos Feder
Chiri-Chiri Deepak Skywalker -> Callum Xander Hishla
Xianchu Zoe Schmidt -> Ryu Rhaj Duong
Jasnah Jacob Epenona -> Galaria Anaya Levin
Lyn Shrivan Geller -> Rhaj Ulrich Magnusson
Tonya Maheen Al-Ghul -> Gwnivere Avni Vurnt
Milan Wynn Faheen -> Vortigern Aeryn Kerbochaurd
Ishna Artemis Smith -> Ashravan Sylphrena Fuchs
Sylphrena Deepak Wayne -> Thane Aurora Hernandez
Corla Raven Smith -> Yurt Honoria Duong
Raven Sim Ashkenazi -> Vin Isabella Whitman
Presley Kat Trenton -> Drobyl Apu Atreides
Ludo Jacob Queens -> Verla Vella Daniels
Sumayah Seltsa Wojciechowski -> Ashravan Atreyu Wayne
Ivanka Rahab Garcia -> Gwnivere Neil Lemont
Zaraphel Meiling Jakzl -> Paul Ziggurah Wozniak
Paris Kat Torval -> Thane Zara Inez
Manuel Prisha Whitman -> Ajit Jacob Dryzt
Isolde Ali O'Reilly -> Ganondorf Grint Miyagi
Meiling Leni Wu -> Krin Eva Zheng
Galaria Alishba Eagle-Feather -> Cassiopiea Paris Yoshida
Luke Wyrm Idaho -> Rhaj Deepak Rubio
Ivanka Serene Lemont -> Guido Geralt Chakma
Valerian Fenix Avraham -> Sumayah Yash Fitzwilliam
Gandalf Zaraphel Jemishek -> Valerian Milo Ogawa
Neil Korath Yamada -> Mehwish Falkor Yamada
Zaraphel Isolde Locke -> Ronin Alishba Epenona
Sonia HoosFoos Xi -> Deepak Emer Jentry
Ishna Ziggurah Roshka -> Shallan Ilya Ashkenazi
Jack Xinyi Gygax -> Ilya Paul California
Ulim Leona Rodanza -> Kale Milan Sol
Honoria Sam Warplanter -> Fisk Verla Leibniz
Ollie Saanvi Nerfherder -> Mehwish Tonya Gates
Apu Kat Uxima -> Gandalf Falkor Gates
Zarbo Webster Chowdury -> Vin Deepak Starsitter
Kelsier Liv Gubler -> Sumayah Seltsa Wojciechowski
Milo Korath Newton -> Thane Geralt Mizrachi
John Presley Ogawa -> Artemis Areesha Jorn
Echo Antonia Blanco -> Korath Galaria Barnes
Ronin Emilia Wayne -> Xinia Tullia Torres
Krishna Sumayah O'Reilly -> Dalinar Xinia Daniels
Ulim Deepak Ashkenazi -> Cho Ravi Kent
Maria Aeryn Avraham -> Drobyl Maheen Evenstar
Corla Callum Sanz -> Natasha Shrivan Carnegie
Valerian Wyrm Rubio -> Krishna Leni Ugnaught
Prisha Shallan Gygax -> Drobyl Zara California
Tullia Atreyu Fandurin -> Mehwish Garter Santa-Cruz
Emer Xinyi Trenton -> Sumayah Meiling Evenstar
Maria Meiling Norton -> Gandalf Cellin Solaris
Xander Aeryn Rockafeller -> Xianchu Zoe Schmidt
Umbra Atreyu Hashimoto -> Ishna Krin Blanco
Foxx Lyn Evenstar -> Xinyi Areesha Jorn
Lyn Fisk McCray -> Krishna Sumayah O'Reilly
Corla Xander Fitzwilliam -> Zaraphel Sreevatsava Schmidt
Xena Deepak Solaris -> Yggsila Garter McCray
Xena Artemis PorSellik -> Zelda Sim Vurnt
Samus Verden Chowdury -> Ulrich Krin Enchiridion
Seltsa Fisk Hishla -> Vortigern Krishna Openheimer
Leia Prisha Leibniz -> Oogex Eve Wan
Callum Yuanchen Sanz -> Anaya Link Al-Ghul
Apu Ryan Azlan -> Zant Antonia Hemonotz
Drobyl Ximena Wojciechowski -> Frodo Jai Stormblessed
Ulim Umbra Jakzl -> Veebux Sumayah Rodriguez
ShaiLu Ximena Stormblessed -> Rin Webster Ahmed
Fenix Gurn Jemishek -> Corla Ollie Nyad
Ryan Botax Enchiridion -> Paris Dalinar Trenton
Ashravan Snimm Wu -> Atskuo Ganondorf Yamada
Cloud Kaladin Kobayashi -> Bill Ulim Vergebrand
Anaya Link Al-Ghul -> Ishna Rhaj Mizrachi
Eva Ishna Anderson -> Rahab Aphra Norton
Yun Llan Skylocke -> Webster Rhaj Wan
Emma Yash Organa -> Quartz Antonia Idaho
Midna Ilena Ahmed -> Eden Anaya Enchiridion
Kale Verla Wayne -> Eve Serene Yeet
Verla Quartz Nerfherder -> Saanvi Khan Iyatil
Yuanchen Fatima Kobayashi -> John Umbra Dunbar
Jennifer Oogex Pratt -> Meiling Azlan
Naruto Jareth Vanderbilt -> Vella Wynn Earthsea
Fisk Jai Blanco -> Kaladin Galaria Newton
Leni Jack Kritikos -> Eve Seltsa Ogawa
Tonya Isolde Syushu -> Jareth Isolde Evenstar
Torol Frodo Smith -> Yezier Emma Sato
Quartz Oogex Starsitter -> Korath Gwnivere Ugnaught
Gwnivere Atskuo Kholin -> Maria Meiling Norton
Zoe Abril Ibrahim -> Gwnivere Ziggurah Organa
Milo Milo Stormblessed -> Luigi Quartz Lemont
Ilena Druzilla Kritikos -> Shrivan Quartz Syushu
Quartz Areesha Tremonton -> Presley Ivanka Mytaras
Shrivan Sylphrena Stormblessed -> Naruto Jareth Vanderbilt
Ilya Frodo Mephistopheles -> Apu Ulim GuYung
Verla Shallan Orbita -> Liv Xander Icthyon
Sumayah Galaria Kondo -> Serene Ryan Centauri
Dalinar Xinia Daniels -> Paris Vortigern Uxima
Natasha Llan Armstrong -> Akio Leona Ogawa
Luke Ryu Murutsuma -> Galaria Areesha Zielinski
Ludo Falkor Whitman -> Ronin Lior Mephistopheles
Rin Xianchu Vanderbilt -> Chiri-Chiri Jack Avraham
Eve Serene Vanderbilt -> Kelsier Kaladin Jorn
Garter Krishna Lezrimond -> Vivenna Neil Vanderbilt
Sam Yggsila Ahmed -> Sumayah Isabella Fuchs
Gwnivere Frodo Kruchev -> Vin Deepak Starsitter
Lyn Jareth Rax -> Yurt Ludo Endo
Cloud Alishba Solaris -> Foxx Jareth Pratt
Xinia Sonia Nyad -> Guido Lior Golubev
Echo Xena Rax -> Cho Umbra Uxima
Shrivan Echo Sentimere -> Ulrich Krin Fitzwilliam
Skar Khan Lezrimond -> Sam Yggsila Ahmed
Callum Sonia Dreyfuss -> Drobyl Galaria Schmidt
Galaria Kelsier Petrovic -> Xander Thane Dryzt
Mehwish Deepak Lemont -> Jai Foxx Azlan
Natasha Jareth Zheng -> Manuel Artemis Schroeder
Rahab Artemis McDonald -> Rahab Llan Torres
Korath Lyn Daniels -> Xena Aurora Cellish
Fisk Emilia Inez -> Ashravan Roroni Pratt
Skar Ishna Fitzwilliam -> Paris Luke Nerfherder
Galaria Jacob Vinson -> Sreevatsava Luke Ibrahim
Gwnivere Buffalo Icthyon -> Vin Ulrich Azlan
Callum Atreyu Rockafeller -> Leni Xena Duong
Eden Leona McCray -> Frodo Natasha Dunbar
Milo Webster Armitage -> Zelda Raven Nightshade
Jai Ravi Ikeda -> Ryan Botax Enchiridion
Samus Rin Anderson -> Wyrm Gwnivere Occam
Yggsila Peggy Ashkenazi -> Jareth Mehwish Dostoyevsky
Han Atreyu Jung -> Maria Aeryn Avraham
Druzilla Zelda Gerrit -> Kale Naruto Armitage
Vella Wynn Earthsea -> Drobyl Xianchu Yoshida
Mehwish Garter Santa-Cruz -> Tyrian Jai Aetheryx
Krin Eva Zheng -> Akio Saanvi Torres
Isolde Yurt Centauri -> Ximena Ulim California
Botax Ulim Daniels -> Liv Llan Kritikos
Tyrian Ludo Vought -> Emer Maria Morales
Septima Paris Atreides -> Echo Julio Elessar
Tullia Midna Sol -> Eve Milan Cheong
Tao Quartz GuYung -> Ilya Paul California
Antonia Rylan Skywalker -> Cloud Prisha Westmore
Jack Shrivan Elessar -> Echo Kale Ford
Ziggurah Maheen Schroeder -> Luke Ajit Wayne
Tullia Abril Yoshida -> Yggsila Ishna Orbita
Geralt Veebux Solaris -> John Tonya Morales
Jack Ulim Sokolov -> Zelda Krin Starsitter
Ilya Garter Lezrimond -> Ravi Dalinar Zheng
Naruto Jareth Vanderbilt -> Callum Vivenna Kholin
Leona Gurn Uxima -> Sonia Paris Syushu
Milan Aphra Wojciechowski -> Quartz Isolde Vogelbaum
Buffalo Jai Halibut -> Cellin Gwnivere Cheong
Rhaj Anaya Yamada -> Ganondorf ShaiLu Locke
ShaiLu Ximena Stormblessed -> Ilya Emer Diego
Aurora Alishba Schmidt -> Eva Aeryn Locke
Akio Drobyl Avraham -> Emma Honoria Cillia
Liv Ajit Lurntz -> Anaya Ziggurah Orbita
Emma Geralt Starsitter -> Neil Yash Endo
Dalinar Lior Ashkenazi -> Paris Ludo Perez
Guido Buffalo Schroeder -> Eden Tao Lemont
Grint Anaya Cheong -> Callum Atreyu Rockafeller
Paul Ziggurah Wozniak -> Jareth Isolde Evenstar
Skar Ulim McMillan -> Zant Presley Endo
Emilia Gurn Rubio -> Neil Ulim Openheimer
Antonia Midna Lemont -> Seltsa Verla Murutsuma
Chiri-Chiri Presley Torres -> Zaraphel Khan Hishla
Oogex Cloud Occam -> Guido Aphra Nyad
Buffalo Ziggurah Armstrong -> Aurora Isabella Hwang
Prisha Gwnivere Nakagawa -> Chiri-Chiri Xianchu Cheong
Lyn Shrivan Geller -> Jack Jack Kendoshi
Honoria Abril Endo -> Seltsa Jacob Centauri
Shallan Eve California -> Areesha Valerian McDonald
Callum Yun Diego -> Shrivan Serene Ingersoll
Prisha Fisk Ginfu -> Krin Buffalo Occam
Echo Zara GuYung -> Yun Skar Jakzl
Dalinar Ludo GuYung -> Veebux Wynn Feder
Verla Krin Lannister -> Samus Wyrm Eagle-Feather
Dalinar Jacob Azlan -> Presley Ganondorf Chakma
Paul Natasha Vogelbaum -> Rahab Aphra Norton
Wyrm Milo Ikeda -> Seltsa Sonia Yoshida
Dalinar Maria Evenstar -> John Emer Blanco
Yezier Aurora Magnusson -> Sylphrena Wynn Zielinski
Eve Dalinar Pratt -> Quartz Drobyl Dryzt
Han Nora Nesbit -> Ravi Dalinar Zheng
Leia Kale Serrano -> Sumayah Areesha Skylocke
Khan Alishba Cillia -> Aeryn Botax Nightshade
Luke Ajit Wayne -> Naruto Corla Melbourne
Atreyu Antonia Lemont -> Shallan Natasha Queens
Rahab Dalinar Daniels -> Veebux Paris Anderson
Xander Xianchu California -> Luke Ajit Wayne
Alister Jareth Sato -> Guido Fatima Dupont
Ziggurah Khan Kholin -> Gurn Ziggurah Wozniak
Alishba Gwnivere Nightshade -> Natasha Garter Whitman
Presley Ravi Hemonotz -> Quartz Tonya Mizrachi
Ashravan Ulim Torval -> Gandalf Jennifer Jakzl
Naruto Corla Melbourne -> Atreyu Liv Kwon
Sim Midna Syushu -> Wyrm Khan Hishla
Zaraphel Vella Geller -> Vin Manuel Diego
Sim Eva Yoshida -> Chiri-Chiri Samus Sentimere
Emma Honoria Cillia -> Krishna Leni Ugnaught
Lyn Avni Dupont -> Eva Ilena Kholin
Krin Alishba Inez -> Shrivan Ryu Ginfu
Cloud Vella Gygax -> Verla Lior Murutsuma
Leia Prisha Leibniz -> Zaraphel Abril Nyad
Ashravan Ulim Torval -> Presley Luigi Anderson
Abril Earnest Kerbochaurd -> Presley Gurn GuYung
Aurora ShaiLu Lestibourne -> Fatima Ajit Rockafeller
Samus Kaladin Barnes -> Eden Kale Centauri
Xinyi Ashravan Zanzibrot -> Shallan Anaya Petrovic
Rylan Meiling Ogawa -> Antonia Jack Venli
Mehwish Ivanka Yusuf -> Geralt Kelsier Jentry
Ajit Valerian Elessar -> Veebux HoosFoos Feder
Chiri-Chiri Xinia Vanderbilt -> Tao Yurt Hashimoto
Aeryn Buffalo Skylocke -> Ajit Kaladin Solo
Emma Ali Mizrachi -> Earnest Echo Ingersoll
Corla Lyn Jemishek -> Callum Roroni Chowdury
Buffalo Bill Rodriguez -> Garter Sumayah Gates
Grint Ollie Roshka -> Link Serene Whitman
Chiri-Chiri Xianchu Cheong -> Vivenna Krin Oberron
Lleshwi Jack Endo -> Avni Buffalo Cillia
Corla Xander Fitzwilliam -> Skar Ishna Fitzwilliam
John Vin Tehuacan -> Krin Eva Zheng
Vin Rin Lemont -> Falkor Jacob Murutsuma
Ximena Rin O'Reilly -> Xianchu Yggsila Golubev
Peggy Cellin Strife -> Tullia Atreyu Fandurin
Grint Botax Hernandez -> Serene Luigi Torval
Skar Khan Lezrimond -> Ximena Xinyi Newton
Botax Ryan Queens -> Galaria Fatima Kerbochaurd
Leni Maria Armitage -> Ivanka Serene Lemont
Echo Eva Wu -> Ryu Quartz Vergebrand
Ximena Fenix Yamada -> Milan Ollie Endo
Shrivan Verla Orbita -> Fisk Drobyl Centauri
Ajit Vin Sokolov -> Xena Sumayah Inez
Vivenna Lior Ogawa -> Jacob Umbra Yeet
Veebux Wynn Feder -> Khan Raven Kent
Earnest Galaria Hemonotz -> Link Lakshi Torval
Lior Druzilla Schwetzer -> Zara Yurt Westmore
Thane Ivanka Earthsea -> Emilia Liv Memnon
Aurora Apu Vought -> Krin Rylan Halibut
Quartz Antonia Idaho -> Krin Ximena Sentimere
Anaya Kelsier Icthyon -> Han Falkor Skywalker
Serene Elessar -> Kat Emilia Wozniak
Zaraphel Sreevatsava Schmidt -> Naruto Vin Rodriguez
Ryan Zara Ford -> Sim Abril Oneida
Milan Artemis California -> Dalinar Ludo GuYung
Ziggurah Saanvi Tehuacan -> Ronin Kale Gerrit
Prisha Ravi Rodriguez -> Alister Ashravan Rockafeller
Chiri-Chiri Presley Torres -> Krishna Atreyu Kent
Eve Serene Vanderbilt -> Alister Yun Miyagi
Eve Antonia Inez -> Ryan Isabella Hwang
Ganondorf Grint Miyagi -> Seltsa Thane Iyatil
Lleshwi Verden Armstrong -> Saanvi Emilia Melbourne
Maheen Midna Wan -> Ryu Manuel Torres
Cho Yuanchen Pratt -> HoosFoos Bill Nakagawa
Anaya Aeryn Gerrit -> Garter Liv Lestibourne
Eva Leia Ogawa -> Aurora Apu Vought
Sumayah Seltsa Wojciechowski -> Sreevatsava Korath Orbita
Sreevatsava Frodo Lestibourne -> Anaya Presley Fandurin
Link Serene Whitman -> Milan Artemis California
Kevin Bacon -> Han Atreyu Jung
Earnest Snimm Sato -> Quartz Drobyl Dryzt
Yezier Paris Occam -> Khan Emilia Feder
Oogex Druzilla Rockafeller -> Guido Areesha Norton
Verla Ivanka Rodriguez -> Anaya Prisha Nakagawa
Ronin Ziggurah Icthyon -> Leni Corla Lannister
Nora Roroni Mejito -> Thane Rin Endo
Verla Oogex Dryzt -> Veebux Thane Mephistopheles
Jacob Rin Gygax -> Sam Ollie Hyprazia
Druzilla Zelda Gerrit -> Xander Ravi Al-Ghul
Cellin Avni Idaho -> Xander Ogawa
Ganondorf Cellin Daniels -> Meiling Xianchu Garcia
Llan Tonya McMillan -> Ajit Korath Pratt
Presley Thane Xi -> Xinia Ganondorf Ford
Zoe Tullia Armstrong -> Ishna Krin Blanco
Ronin Fisk Gates -> Zelda Tao Ogawa
Rylan Valerian Jemishek -> Falkor Manuel Vinson
Link Isolde Roshka -> Milo Webster Armitage
Vivenna Yuanchen Venli -> Korath Kat McMillan
Samus Kaladin Barnes -> Falkor Antonia Epenona
Leni Corla Lannister -> Seltsa Emma Roshka
Presley Alishba Skywalker -> Sreevatsava Liv Schroeder
Cassiopiea Roroni Golubev -> ShaiLu Lyn Nerfherder
Isabella Paris Levin -> Umbra Galaria Leibniz
Wynn Llan Hashimoto -> Avni Gwnivere Evenstar
Zaraphel Abril Nyad -> Shrivan Frodo Dryzt
Cellin Rahab Mizzrimor -> Sumayah Thane Leibniz
Krin Rylan Halibut -> Ciri Meiling Gubler
Bill Frodo Ikeda -> Korath Ryan Garcia
HoosFoos Chiri-Chiri Nyad -> Kale Gwnivere Sentimere
Presley Lleshwi Chakma -> Sreevatsava Avni Solaris
Zant Isabella Quetzelos -> Eva Skar Kent
Bill Xinyi Morales -> ShaiLu Vella Barnes
Aurora Lakshi Starsitter -> Valerian Wyrm Rubio
Leni Ryan Leibniz -> Kaladin Septima Fandurin
Mehwish Jack McCray -> Yuanchen Echo Kent
Jack Lakshi Carnegie -> Han Neil Syushu
Skar Presley Ingersoll -> Callum Sonia Dreyfuss
Ishna Emer Ramos -> Ludo Ravi Kritikos
Xinyi Gurn Guyaux -> Presley Oogex Chowdury
Corla Llan Nightshade -> Skar Lyn Faheen
Yurt Xinia Kendoshi -> Oogex Cloud Occam
Krin Buffalo Occam -> Yggsila Fatima Rodriguez
Ryu Apu Trenton -> Xianchu Roroni Nesbit
Ivanka Anaya Lannister -> Verla Kelsier Jentry
Yuanchen Apu Miyagi -> Ganondorf Aeryn Lestibourne
Antonia Emer Diego -> Gwnivere Ziggurah Organa
Tyrian Ludo Vought -> Sylphrena Cloud Feder
Vin Verden Yusuf -> Kaladin Shallan Openheimer
Tullia Midna Nesbit -> Julio Ajit Oneida
Abril Deepak Magnusson -> Yuanchen Ashravan Lemont
Gandalf Xena Torres -> Midna Lakshi Blanco
Gurn Tao Dostoyevsky -> Ulim Saanvi Golubev
Earnest Deepak McDonald -> Xinyi Wyrm Stormblessed
Garter Ashravan Nesbit -> Meiling Ilena Skylocke
Yurt Honoria Duong -> Ravi Umbra Zheng
Milan Maheen Hemonotz -> Krishna Wyrm Fitzwilliam
Grint Ollie Roshka -> Bill Xinyi Ginfu
Jai Verla Trenton -> Antonia Midna Lemont
Jacob Dalinar Chakma -> Ilya Quartz Daniels
Gandalf Ciri Vogelbaum -> Frodo Xinyi Schroeder
Gwnivere Guido Armitage -> Samus Verden Chowdury
Han Neil Syushu -> Maheen Maria Organa
Zant Xianchu Ramos -> Dalinar Naruto Dryzt
Shrivan Snimm Azlan -> Torol Eva Inez
Rahab Khan Mizzrimor -> Septima Emilia Carnegie
Sreevatsava Tullia Rodriguez -> ShaiLu Cassiopiea Schmidt
Zelda Midna O'Reilly -> Saanvi Raven Geller
Rylan Alishba Leibniz -> Xander Aeryn Rockafeller
Seltsa Thane Iyatil -> Alishba Kale Kruchev
Quartz Tyrian Openheimer -> Tonya Ashravan Starsitter
Meiling Sim Murutsuma -> Sim Midna Syushu
Shrivan Corla Enchiridion -> Emer Echo Hwang
Artemis Areesha Jorn -> Abril Shallan Mejito
Cho Leia Kendoshi -> Link Skar PorSellik
Raven Fatima Masahiro -> Maheen Xander Inez
Samus Verden Chowdury -> Geralt Veebux Solaris
Tonya Rhaj Melbourne -> Rhaj Milan Nerfherder
Krishna Prisha Morales -> Lior Zaraphel Dryzt
Gwnivere Ziggurah Organa -> Leni Tyrian Vinson
Avni Alishba Sokolov -> Raven Midna Levin
Cassiopiea Manuel Avraham -> Jasnah Rylan Masahiro
Cho Ravi Kent -> Ziggurah HoosFoos Faheen
Ilya Kale Hemonotz -> Milo Thane Dostoyevsky
Gurn Ziggurah Wozniak -> Thane Deepak Rodanza
Krishna Wyrm Fitzwilliam -> Jacob Avni Eagle-Feather
Buffalo Sreevatsava Yusuf -> Lleshwi Vortigern Morales
Deepak Ilya Chowdury -> Ilya Frodo Mephistopheles
Liv Llan Kritikos -> Kat Yurt Dostoyevsky
Milo Milo Stormblessed -> John Gwnivere Gerrit
Maria Vivenna Ford -> Naruto Eden Kent
Sim Fatima Torval -> Link Naruto Xi
Gwnivere Buffalo Icthyon -> Roroni Buffalo Centauri
Ilena Verden Organa -> Fisk Falkor Vogelbaum
ShaiLu Guido Ibrahim -> Cloud Presley Barnes
Sumayah Yash Fitzwilliam -> Akio Botax Nesbit
Maria Ajit Mejito -> Link Botax Kruchev
Wynn Sim Rockafeller -> Falkor Jacob Murutsuma
Atreyu Liv Kwon -> Cloud Kaladin Kobayashi
Han Atreyu Jung -> Grint Ollie Roshka
Fisk Drobyl Geller -> Ronin Lior Mephistopheles
Aurora Apu Vought -> Abril Deepak Magnusson
Prisha Honoria Kent -> Sreevatsava Frodo Lestibourne
Xena Deepak Solaris -> Alishba Quartz Nakagawa
Antonia Jack Venli -> Prisha Atreyu Ikeda
Rhaj Lyn Magnusson -> Ilena Druzilla Blanco
Verla Luke Geller -> Xianchu Seltsa Pratt
Leni Xena Duong -> Cassiopiea Vivenna Ashkenazi
Luigi Yun Syushu -> Grint Guido Sato
Eva Vin Ogawa -> Verla Paris Pratt
Maria Han Earthsea -> Eve Fatima Norton
Xena Ilena Wayne -> Kale Lior Roshka
Manuel Yash Nyad -> Natasha Jareth Zheng
Yun Llan Skylocke -> Bill Xinyi Morales
Yggsila Atreyu Tehuacan -> Sonia Yash Anderson
Foxx Leni Rax -> Sreevatsava Nora Al-Ghul
Sylphrena Rahab Lannister -> Gurn Galaria Dupont
Ziggurah Zarbo Uxima -> Lleshwi Nora Aetheryx
Sreevatsava Liv Schroeder -> Zoe Vin Kondo
Vin Cho Jakzl -> Jennifer Abril Ford
Prisha Naruto Blanco -> Raven Midna Levin
Presley Ivanka Mytaras -> Atreyu Buffalo Schwetzer
Mehwish Ivanka Yusuf -> Dalinar Liv Lopez
Emma HoosFoos Hemonotz -> HoosFoos Bill Nakagawa
Presley Ivanka Mytaras -> Jasnah Gurn Ramos
Leni Maheen Dryzt -> Yun Llan Skylocke
Tao Liv Solaris -> Anaya Ziggurah Orbita
Raven Chiri-Chiri Ramos -> Rhaj Atskuo Suarez
Isabella Milo Nakagawa -> Leni Maheen Dryzt
Valerian Ivanka Lannister -> Jack Lakshi Carnegie
Gandalf Xena Torres -> Artemis Alister Melbourne
Roroni Neil Jemishek -> Luigi Septima Leibniz
Apu Xinia Yeet -> Kale Vortigern Fitzwilliam
Seltsa Jennifer Fuchs -> Kat Lleshwi Hernandez
Paris Ludo Perez -> Alishba Ravi Lezrimond
Rhaj Wyrm Yoshida -> Kale Ulim Vought
Sam Ollie Hyprazia -> Ivanka Yurt Murutsuma
Ximena Han Vanderbilt -> HoosFoos Kat Openheimer
Alishba Kale Kruchev -> Aeryn Xinyi Miyagi
Jacob Falkor Gygax -> Xena Saanvi Nightshade
Cellin Avni Idaho -> Yurt Lleshwi Volkov
Antonia Midna Lemont -> Julio Emer Masahiro
Jai Falkor California -> Xander Khan Wozniak
Xianchu Callum Mizzrimor -> Ulim Drobyl Westmore
Ishna Jareth Sato -> Seltsa Septima Dryzt
Ishna Veebux Quetzelos -> Eva Wyrm Vinson
Cho Samus Hishla -> Callum Shallan Blanco
Sumayah Zelda Dostoyevsky -> Ollie Fenix Westmore
Paris Vivenna Murutsuma -> ShaiLu Cassiopiea Schmidt
Sam Yun Hashimoto -> Eden Xianchu Nesbit
Ilena Llan Ibrahim -> Neil Xinia Armitage
Jennifer Lyn Icthyon -> Jennifer Snimm Hwang
Jack Shrivan Chowdury -> Zara Roroni Wu
Alister Veebux Epenona -> Roroni Ziggurah Vogelbaum
John Presley Ogawa -> Verla Ollie Lemont
Ziggurah Saanvi Tehuacan -> Apu Fisk Occam
Neil Roroni Morales -> Ronin Alishba Epenona
Xianchu Yggsila Golubev -> Cassiopiea Cassiopiea Zanzibrot
Serene Ryan Centauri -> Jareth Midna Zielinski
Skar Zelda Suarez -> Tonya Rhaj Melbourne
Kat Tullia Masahiro -> Ivanka Botax Ramos
Jack Lakshi Carnegie -> Meiling Fenix Perez
Honoria ShaiLu Garcia -> Midna Sam Leibniz
Cassiopiea Tyrian Wan -> Abril Serene Mephistopheles
Yurt Cloud PorSellik -> Apu Rhaj Sokolov
Sim Saanvi Solo -> Botax Vivenna Torres
Link Serene Whitman -> Serene Shrivan Nightshade
Cassiopiea Gwnivere Enchiridion -> Ulim Wyrm Jentry
Liv Xander Icthyon -> Ryan Isabella Hwang
Ziggurah HoosFoos Faheen -> Verla Zelda Lezrimond
Garter Sumayah Gates -> HoosFoos Paris Ramos
Ciri Ulrich Tehuacan -> Botax Atskuo Rasmussen
Fisk Ronin Blanco -> Julio Zaraphel Cheong
Ludo Tao Occam -> Cassiopiea Luke Anderson
Leona Verla Rockafeller -> Tonya Zaraphel Venli
Aphra Han Inez -> Drobyl Shrivan Volkov
Natasha Jareth Zheng -> Yun Quartz Perez
Vin Aphra Ogawa -> Alister Veebux Epenona
Tyrian Jai Aetheryx -> Rylan Meiling Ogawa
Septima Presley Starsitter -> Zoe Abril Ibrahim
Skar Paris Orbita -> Akio Jennifer Mejito
Emma Yezier Sentimere -> Neil Korath Yamada
Kale Ilena Rockafeller -> Ivanka Ivanka Gates
Leni Ryu Dryzt -> Avni Milo Cheong
Link Rin Cheong -> Rhaj Ivanka Ahmed
Sam Yun Hashimoto -> Ajit Emilia Geller
Sonia HoosFoos Xi -> Serene Jasnah Feder
Emma Geralt Starsitter -> Rahab Kaladin Norton
Jasnah Aphra Kruchev -> Nora Xinyi Wayne
Druzilla Xinia Levin -> Jareth Raven Schroeder
Falkor Jacob Lannister -> Ivanka Yezier GuYung
Korath Gwnivere Ugnaught -> Emilia Midna Evenstar
Seltsa Emma Roshka -> Maheen Midna Wan
Shrivan Snimm Azlan -> Vortigern Shallan Uxima
Valerian Ivanka Lannister -> Eva Leia Ogawa
Ganondorf Xinyi Idaho -> Eve Milan Cheong
Thane Veebux Oneida -> Yuanchen Echo Kent
Xinia Ximena Lestibourne -> Anaya Leona Hishla
Samus Cassiopiea Kritikos -> Thane Midna Icthyon
Naruto Roroni Occam -> Kat Tullia Masahiro
Foxx Dalinar Ramos -> Guido Neil Rax
Ronin Fisk Gates -> Xena Ludo Smith
Snimm Luigi Jorn -> Vortigern Webster Stormblessed
Vortigern Ashravan Epenona -> Gurn Ivanka Murutsuma
Serene Julio Fitzwilliam -> Ryan Ilena Dreyfuss
Eve Serene Jung -> Krin Shrivan Vurnt
Luke Wyrm Idaho -> Jennifer Oogex Pratt
Shallan Garter Queens -> Druzilla Zelda Gerrit
Ollie Yun Gygax -> Ishna Emer Ramos
Ilena Quartz Rubio -> Veebux Korath McCray
Presley Ravi Hemonotz -> Deepak Fisk Westmore
Septima Sylphrena Dreyfuss -> Geralt Emma Vurnt
Dalinar Naruto Dryzt -> Guido Meiling California
Cellin Aeryn Mizrachi -> Thane Khan Earthsea
Avni Garter Magnusson -> Ryu Rhaj Duong
Vella Peggy Yusuf -> Ronin Fisk Gates
Liv Leona Barnes -> Wynn Ziggurah Fitzwilliam
Ivanka Julio Chowdury -> Leona Zoe Diego
Ximena Vivenna Kwon -> Ajit Samus Anderson
Frodo Jai Stormblessed -> Roroni Ziggurah Vogelbaum
Khan Peggy Uxima -> Xinyi Ashravan Schmidt
Sim Abril Oneida -> Leona Kelsier Atreides
Artemis Jack Petrovic -> Alishba Vin Wan
Grint Guido Sato -> Zarbo Webster Chowdury
Xinyi Honoria Daniels -> Ryu Eden Feder
Sam HoosFoos Guyaux -> Emer Jennifer Uxima
Neil Foxx Magnusson -> Sumayah Frodo Schwetzer
Drobyl Shrivan Volkov -> Ishna Jareth Sato
Neil Tyrian Zheng -> Milan Foxx Nakagawa
Buffalo Verden Sentimere -> Isolde Aurora Aetheryx
Presley Jasnah Tremonton -> Callum Yun Diego
Eve Xinyi Diego -> Fisk Emilia Inez
Verla Bill Schroeder -> Tao Jennifer Tehuacan
Naruto Serene Mizzrimor -> Jacob Rin Gygax
Nora Antonia Schwetzer -> Nora Botax GuYung
Cellin Veebux Schroeder -> Vortigern Krishna Openheimer
Seltsa Septima Dryzt -> Jareth Presley Armstrong
Zara Yurt Westmore -> Yurt Gwnivere Ogawa
Alister Umbra Levin -> Gurn Gandalf Ogawa
Eve Serene Jung -> Kale Lleshwi Volkov
Abril Rahab Rasmussen -> Fisk Paul Xi
Mehwish Tonya Gates -> Ilya Jareth Inez
Eve Luke Oberron -> Krin Jai Suarez
Alister Leni Mizzrimor -> Frodo Lyn Epenona
Maheen Galaria Stormblessed -> Yggsila Naruto Sato
Ashravan Snimm Wu -> Lleshwi Mehwish Ginfu
Cassiopiea Paris Yoshida -> Cloud Abril Rodanza
Jack Yggsila Kholin -> Sonia Quartz Pleides
Sylphrena Antonia Serrano -> HoosFoos Eve Kobayashi
Zelda Antonia Cheong -> Ashravan Ashravan Newton
Julio Grint Magnusson -> Shallan Krishna Nyad
Zara Rin Halibut -> Atreyu Shallan GuYung
Grint Vortigern Dreyfuss -> Meiling Leni Wu
Callum Antonia Jung -> Manuel Thane Nyad
Zelda Prisha Evenstar -> Shallan Chiri-Chiri Rax
Naruto Naruto Carnegie -> Xinyi Ashravan Schmidt
Tullia Lleshwi Rockafeller -> Llan Rahab Uxima
Galaria Leona Endo -> Midna Atreyu Pratt
Veebux Sumayah Rodriguez -> Rylan Verden Dreyfuss
Aphra Antonia Nerfherder -> Rin Wynn Idaho
Natasha Foxx Morales -> Anaya Presley Fandurin
Shallan Mehwish Locke -> Shrivan Verla Orbita
Maheen Quartz Leibniz -> Gandalf Lakshi Kondo
Midna Thane Gubler -> Garter Emilia Mizrachi
Valerian Milo Ogawa -> Ximena Ulim Armitage
Ivanka Vin Guyaux -> Vivenna Neil Vanderbilt
Maheen Quartz Evenstar -> Veebux Wynn Oberron
Vella Peggy Yusuf -> Leni Jack Kritikos
Alishba Torol Duong -> Echo Kale Ford
Isabella Xena Magnusson -> Bill Ilena Kondo
Lior Zaraphel Dryzt -> Vivenna Krin Oberron
Kale Lior Roshka -> Meiling Ronin Rockafeller
Prisha Korath Avraham -> Gurn Ulrich Vogelbaum
Isolde Sylphrena Kobayashi -> Ishna Akio Gygax
Atskuo Kelsier Kritikos -> Saanvi Midna Yamada
Serene Shrivan Nightshade -> Tao Garter Eagle-Feather
Ganondorf Prisha Gubler -> Krin Alishba Inez
Shrivan Frodo Dryzt -> Alishba Frodo Armstrong
Isolde Grint Ikeda -> Tonya Isolde Syushu
Garter Sreevatsava Aetheryx -> Seltsa Tonya Sanz
Ryan Oogex Armstrong -> Eve Serene Yeet
Jai Foxx Azlan -> Paris Ludo Perez
ShaiLu Lyn Nerfherder -> Emer Paris Ramos
Botax Vivenna Torres -> Jasnah Lyn Ogawa
Ollie Ilya Kent -> Tullia Icthyon
Yuanchen Grint Rax -> Naruto Serene Mizzrimor
Milan Aphra Wojciechowski -> Isabella Avni Dupont
Ronin Ryan Sato -> Yurt Honoria Duong
Veebux HoosFoos Feder -> Lyn Fisk McCray
Torol HoosFoos Foorl -> Sim Eva Yoshida
Rin Xianchu Vanderbilt -> Yash Deepak McCray
Gurn Druzilla Kwon -> Bill Aphra Dreyfuss
Eve Luke Oberron -> Sim Skar Garcia
Gurn Ziggurah Wozniak -> Ludo Fatima Syushu
Natasha Garter Whitman -> Meiling Emilia Enchiridion
Fisk Umbra GuYung -> Shrivan Vella Feder
Oogex Han Kruchev -> Yurt Xinia Kendoshi
Atreyu Xinia Pleides -> Cloud Ilya Rasmussen
Presley Sam Morales -> John Vin Tehuacan
Luke Ravi Ogawa -> Zelda Veebux Kwon
Apu Wynn Cheong -> Zant Honoria Centauri
Deepak Mehwish Carnegie -> Yggsila Naruto Sato
Oogex Eve Wan -> Rin Xianchu Vanderbilt
Kelsier Yggsila Leibniz -> Ludo Krin Yusuf
Xena Lleshwi Murutsuma -> Maria Eden Foorl
Yggsila Garter McCray -> Naruto Armitage
Roroni Isabella Jung -> Shrivan Vella Feder
Seltsa Nora Sanz -> Falkor Rin Vergebrand
Gwnivere Luigi Quetzelos -> Mehwish Oogex Starsitter
Yun Emma Chowdury -> Cassiopiea Roroni Golubev
Xianchu Maria Lestibourne -> Leona Rhaj Mytaras
Ilena Llan Ibrahim -> Ulim Leona Rodanza
Veebux Verla Yusuf -> Akio Krin Yoshida
Apu Ulim GuYung -> Dalinar Lior Ashkenazi
Yggsila Yggsila Fitzwilliam -> Umbra Rhaj McDonald
Atskuo Chiri-Chiri Kondo -> Presley Atreyu Occam
Ivanka Ivanka Gates -> Isabella Earnest Daniels
Ciri Mehwish Fuchs -> Eve Serene Jung
Tyrian Areesha Dupont -> Lyn Jareth Rax
Veebux Milo Carnegie -> Nora Antonia Schwetzer
Dalinar Dalinar Faheen -> Ilena Druzilla Kritikos
Atskuo Gurn Icthyon -> Eve Serene Vanderbilt
Maheen Link Vought -> Zara Zarbo Skywalker
Midna Sam Leibniz -> Earnest Ravi Starsitter
Yurt Xinia Kendoshi -> Sumayah Quartz Ahmed
Shrivan Tao Trenton -> Emma Yash Organa
Ajit Sim Stormblessed -> Sumayah Galaria Kondo
Avni Cho Gerrit -> Gandalf Kritikos
Valerian Neil Vinson -> Raven Luke Tremonton
Nora Xinyi Wayne -> Eva Tyrian Ogawa
Maria Han Earthsea -> Frodo Ashravan Sato
Grint HoosFoos Queens -> Isolde Rylan Lezrimond
Xinia Gurn Cellish -> Jai Neil Kritikos
HoosFoos Druzilla Organa -> Aeryn Kelsier Serrano
Yash Sylphrena Rax -> Artemis Jack Petrovic
Ishna Rhaj Mizrachi -> Cassiopiea Vivenna Ashkenazi
Cassiopiea Jennifer Kerbochaurd -> Antonia Zelda Diego
Bill Frodo Ikeda -> Ajit Emma Wozniak
Gurn Gandalf Ogawa -> Ilya Quartz Daniels
Prisha Yezier Ikeda -> Akio Krin Yoshida
Oogex Lyn Petrovic -> Zarbo Presley McCray
Fatima Aeryn Trenton -> Lyn Tyrian Eagle-Feather
Eden Echo Pratt -> Korath Falkor Solaris
Kevin Bacon -> Cloud Maheen Cillia
Eve Jack Yoshida -> Eve Antonia Inez
Zant Krishna Venli -> Sylphrena Frodo Inez
Neil Tyrian Zheng -> Zara Guido Sato
Ashravan Stormblessed -> Abril Raven Sato
Tyrian Zant Torval -> Ali Yurt Hwang
Ishna Veebux Quetzelos -> Ali Rhaj Sol
Cassiopiea Luke Anderson -> Presley Ilena Iyatil
Zara Roroni Wu -> Avni Garter Magnusson
Abril Lyn Zanzibrot -> Eden Rylan Oberron
Yuanchen Ashravan Lemont -> Cassiopiea Jennifer Kerbochaurd
Vortigern Khan Schmidt -> Rahab Naruto Dostoyevsky
Kelsier Yggsila Leibniz -> Skar Ulim Halibut
Ryu Apu Trenton -> Yun Ilya McMillan
Jacob Eden Atreides -> Tyrian Ryu Quetzelos
Jareth ShaiLu Oneida -> Antonia Emer Diego
Sylphrena Cloud Feder -> Xander Lior Memnon
Yurt Umbra Lemont -> Xianchu Eden Anderson
Callum Yun Diego -> Ciri Mehwish Fuchs
Aphra Kale Rodanza -> Zaraphel Isolde Locke
Rahab Ulrich Faheen -> Sam Atskuo Guyaux
Rin Ryu Suarez -> Geralt Emma Vurnt
HoosFoos Tullia Westmore -> Seltsa Tonya Sanz
Yuanchen Echo Kent -> Jennifer Serene Eagle-Feather
Chiri-Chiri Ganondorf Avraham -> Garter Liv Lestibourne
Rin Zara Kendoshi -> Oogex Guido McDonald
Lyn Paul Norton -> Maria Han Earthsea
Dalinar Sam Gubler -> Alishba Valerian O'Reilly
Kat Tullia Masahiro -> Serene Rin Jemishek
Paris Guido Kendoshi -> Eve Antonia Inez
Fisk John Jorn -> Anaya Quartz Jemishek
Guido Geralt Chakma -> Atreyu Liv Kwon
Krishna Yuanchen Tehuacan -> Chiri-Chiri Xianchu Cheong
Han Prisha Rax -> Eve Jennifer Smith
Callum Naruto Mephistopheles -> Ishna Aurora Eagle-Feather
Jack Verden Inez -> Samus Aphra Ramos
Ashravan Wynn Kendoshi -> Frodo Ulim Rax
Vortigern Guido Dryzt -> Zelda Jai Ingersoll
Xinia Wynn Morales -> Manuel Thane Nyad
Milo Falkor Nightshade -> John Vin Tehuacan
Emma Luigi Lannister -> Khan Emilia Feder
Ciri Drobyl Kobayashi -> Shallan Chiri-Chiri Rax
Umbra Apu Fuchs -> Corla Fisk Avraham
Kat Ciri Atreides -> Jack Shrivan Chowdury
Vin Zant Yusuf -> Xena Saanvi Nightshade
Wynn Emer Vanderbilt -> Apu Peggy Lezrimond
Milo Thane Dostoyevsky -> Yggsila Yggsila Fitzwilliam
Maria Rahab Norton -> Sumayah Frodo Schwetzer
Meiling Jorn -> Bill Aphra Dreyfuss
Sam Jennifer Daniels -> Avni Alishba Sokolov
Ryu Quartz Vergebrand -> Prisha Galaria Norton
Tonya Ashravan Starsitter -> Presley Liv Quetzelos
Kaladin Galaria Newton -> Prisha Eden Hernandez
Ximena Xinyi Newton -> Neil Tyrian Zheng
Serene Rhaj Ikeda -> Jareth Ilya Sentimere
Sonia Oogex Ingersoll -> Deepak Mehwish Carnegie
Antonia ShaiLu Uxima -> Eve Nora Nyad
Honoria Ziggurah Ibrahim -> Shallan Eve California
Ximena Jasnah Organa -> Ilya Ollie Chowdury
Isabella Jacob Vanderbilt -> Julio Fisk Vinson
Krin Jai Suarez -> Galaria Korath Rubio
Emilia Liv Memnon -> Vortigern Ilya Idaho
Aeryn Xinyi Miyagi -> Thane Jennifer PorSellik
Ollie Yun Gygax -> Milo Milo Stormblessed
Druzilla Ollie Halibut -> Maheen Quartz Smith
HoosFoos Chiri-Chiri Nyad -> Leni Xianchu Gygax
Paris Dalinar Trenton -> Thane Kat Melbourne
Xinia Ronin Inez -> Zelda Thane Dunbar
Ashravan Emilia Openheimer -> Jack Sumayah Wayne
Leni Korath Dupont -> Liv Vella Lurntz
Fisk Emilia Inez -> Krin Sim Perez
Antonia Rylan Skywalker -> Aeryn Leia Yamada
Quartz Vin Icthyon -> Lior Valerian Stormblessed
Jennifer Falkor Feder -> Naruto Sim Openheimer
Jennifer Serene Eagle-Feather -> Seltsa Fisk Hishla
Foxx Khan Nesbit -> Yuanchen Grint Rax
Sonia Abril Skywalker -> Avni Gwnivere Evenstar
Tyrian Jai Aetheryx -> Xena Deepak Solaris
Sim Zarbo Barnes -> HoosFoos Kat Openheimer
Atskuo Ulrich Santa-Cruz -> Sonia Apu Diego
Lleshwi Nora Aetheryx -> Midna Ilena Ahmed
Snimm Seltsa Ahmed -> Korath Lyn Daniels
Valerian Milo Ogawa -> Julio Maria Idaho
Saanvi Maria Nerfherder -> Sreevatsava Zelda Vought
Neil Foxx Lestibourne -> Kat Lleshwi Hernandez
Oogex Cloud Occam -> Anaya Grint Torres
Alishba Rylan Armstrong -> Sreevatsava Liv Schroeder
Jacob Avni Eagle-Feather -> Avni Garter Magnusson
Earnest Tonya Yoshida -> Emma Yash Organa
Apu HoosFoos Cheong -> Umbra Milo Oneida
Midna Zoe Gygax -> Yggsila Peggy Ashkenazi
Vivenna Xianchu Ikeda -> Valerian Ingalor
Umbra Rhaj McDonald -> Ryu Manuel Torres
Roroni Samus Yamada -> Thane Khan Earthsea
Valerian Manuel Wan -> Rylan Alishba Leibniz
Jacob Ali Rubio -> Xena Nora Nightshade
Chiri-Chiri Xinia Oneida -> Mehwish Ivanka Yusuf
Alishba Ganondorf Masahiro -> Peggy Tao Hashimoto
Manuel Leia Zheng -> Paul Umbra Yamada
Vin Ciri Rockafeller -> Umbra Rylan Dostoyevsky
Llan Khan Morales -> Ximena Buffalo Serrano
Sreevatsava Luke Ibrahim -> Shallan Yun Golubev
Eve Serene Yeet -> Vella Ravi Iyatil
Xianchu Geralt Trenton -> Ivanka Ivanka Gates
Verden Wynn Ibrahim -> Foxx Ishna Leibniz
Ravi Ryan Smith -> Saanvi Raven Geller
Callum Shallan Blanco -> Atskuo Sim Cheong
Torol Ulrich Jung -> Vivenna Samus Ramos
Sumayah Apu Suarez -> Cho Samus Hishla
Corla Ali Masahiro -> Neil Roroni Morales
Yezier Krishna Garcia -> Xander Maheen Ramos
Ryu Lyn Vergebrand -> Zara Xander Dunbar
Earnest Yezier Yoshida -> Yun Midna Barnes
Ganondorf Yun Wayne -> Seltsa Fisk Hishla
Jasnah Aeryn Anderson -> Ximena Jasnah Organa
Kale Milan Sol -> Jack Samus Miyagi
Prisha Gandalf Vurnt -> Ajit Kaladin Solo
Ximena Zara Dreyfuss -> Eden Isabella Kerbochaurd
Guido Neil Rax -> Isabella Anaya Avraham
Sreevatsava Webster Tehuacan -> Rahab Wyrm Murutsuma
Yezier Alishba GuYung -> Aeryn Xinyi Miyagi
Avni Milo Cheong -> Xianchu Tullia Rodanza
Galaria Areesha Zielinski -> Wyrm Shrivan Nyad
Xena Deepak Cheong -> Link Eva Rubio
Khan Raven Kent -> Manuel Prisha Whitman
Quartz Areesha Tremonton -> Ryu Lyn Vergebrand
Veebux Kelsier Schmidt -> Anaya Jai Ginfu
Emilia Septima Feder -> Veebux Isolde Ikeda
Ganondorf Aeryn Lestibourne -> Lyn Rylan Dostoyevsky
HoosFoos Atskuo Rodriguez -> Xianchu Yggsila Golubev
Chiri-Chiri Xinia Oneida -> Maria Nora Torres
Tullia Lleshwi Rockafeller -> Luigi Dalinar Jorn
Gandalf Ciri Vogelbaum -> Gwnivere Naruto Ashkenazi
Ximena Ziggurah Gygax -> Geralt Galaria Warplanter
Verla Quartz Nerfherder -> Ilena Quartz Rubio
Isabella Midna Wozniak -> Ludo Guido Quetzelos
Jasnah Leia Lannister -> Eve Xinyi Diego
Webster Rhaj Wan -> Alishba Zelda Sokolov
Zara Galaria Kobayashi -> Tyrian Zant Torval
Yezier Alister Hwang -> Leona Zoe Diego
Akio Leona Ogawa -> Zaraphel Meiling Jakzl
Shrivan Vella Feder -> Cloud Alishba Solaris
Seltsa Umbra Masahiro -> Sylphrena Lyn Armstrong
Sim Skar Garcia -> Sim Milo Kritikos
Aeryn Xinyi Lurntz -> Quartz Vin Icthyon
Thane Khan Earthsea -> Maheen Quartz Smith
Ravi Eden Ugnaught -> Dalinar Gurn Hemonotz
Jack Sumayah Wayne -> Vortigern Ilya Idaho
Jennifer Lyn Icthyon -> Ulrich Zoe Ramos
Quartz Drobyl Dryzt -> Veebux Yash Evenstar
Isolde Ximena Atreides -> Julio Grint Magnusson
Ajit Sim Stormblessed -> Ollie Yun Gygax
Atskuo Tullia Schwetzer -> Jareth Ciri Magnusson
Quartz Yggsila Organa -> Lleshwi Jack Endo
Kaladin Serene Solo -> Eden Echo Pratt
Naruto Leona Hashimoto -> Lior Zaraphel Dryzt
Eve Jennifer Smith -> Julio Anaya Sato
Gandalf Samus Trenton -> Frodo Ulim Rax
Frodo Natasha Dunbar -> HoosFoos Ganondorf Anderson
Foxx Liv Ogawa -> Alister Yun Yeet
Zaraphel Khan Hishla -> Deepak Yurt Locke
Ciri Ulrich Norton -> Deepak Mehwish Carnegie
Kale Vortigern Fitzwilliam -> Avni Seltsa Masahiro
Gwnivere Snimm Locke -> Verden Wynn Ibrahim
Chiri-Chiri Deepak Skywalker -> Gurn Wynn Serrano
Vin Jack Anderson -> Meiling Xena Levin
Kale Ziggurah Wu -> Natasha Honoria Kondo
Drobyl Krishna Torres -> Alister Abril Xi
Botax Sim Rodanza -> Ishna Isabella Cellish
Ryu Lyn Vergebrand -> Corla Honoria Tremonton
Ali Yurt Stormblessed -> Ludo Guido Quetzelos
Vin Ulrich Azlan -> Earnest Yezier Yoshida
Areesha Valerian McDonald -> Yurt Umbra Lemont
Yezier Emma Sato -> Meiling Seltsa Guyaux
Fatima Lior Oneida -> Tonya Maheen Al-Ghul
Sonia Quartz Pleides -> Buffalo Ziggurah Armstrong
Ryan Verden McCray -> Jennifer Paul Rodriguez
Dalinar Emilia Syushu -> Akio Leona Ogawa
ShaiLu Cassiopiea Schmidt -> Rhaj Zarbo Jentry
Ali Yurt Hwang -> Ryan Botax Enchiridion
Ziggurah Khan Kholin -> Ciri Ulrich Tehuacan
Aurora Isabella Hwang -> Veebux Milo Carnegie
Buffalo Sreevatsava Yusuf -> Sylphrena Ajit Sanz
Sylphrena Paris Syushu -> Foxx Leni Rax
Zelda Krishna Occam -> Gurn Korath Fandurin
Tonya Ashravan Starsitter -> Isabella Seltsa Dostoyevsky
Webster Ajit California -> Cloud Presley Barnes
Sam Yggsila Ahmed -> Alister Jareth Sato
Echo Milan Nyad -> Ryan Tullia Mizrachi
Isolde Sylphrena Kobayashi -> Saanvi Eve Yamada
Botax Sim Rodanza -> Cassiopiea Oogex Sanz
Oogex Guido McDonald -> Jack Sumayah Wayne
Foxx Lyn Evenstar -> Serene Luke Gygax
Ishna Ulrich Ramos -> Zaraphel Jasnah Lemont
Sylphrena Paris Syushu -> Sam Ravi Gerrit
Ilya Valerian Jung -> Septima Emilia Carnegie
Cellin Ryan Idaho -> Tao Galaria Dunbar
Ulrich Krin Enchiridion -> Yggsila Ravi Atreides
Snimm Paul Wojciechowski -> Zaraphel Sonia Elessar
Yun Yuanchen Lopez -> Skar Zelda Suarez
Sonia Ilena Gates -> Natasha Zoe GuYung
Liv Prisha Anderson -> Fisk Garter Vogelbaum
Corla Ollie Nyad -> Zant Krishna Venli
Gwnivere Naruto Ashkenazi -> Gandalf Zaraphel Jemishek
Leni Jack Kritikos -> Kaladin Buffalo Rasmussen
Fisk Ishna Anderson -> Eva Drobyl Nerfherder
Sreevatsava Luke Ibrahim -> Sumayah Zelda Dostoyevsky
Link Xianchu Inez -> Cassiopiea Krin Carnegie
Ollie Dalinar Kendoshi -> Guido Areesha Norton
Earnest Ravi Starsitter -> Garter Ashravan Nesbit
Kelsier Galaria Miyagi -> Ziggurah Honoria Chakma
Kale Druzilla Mizzrimor -> Fenix Ajit Aetheryx
Ximena Buffalo Serrano -> Meiling Seltsa Guyaux
Ciri Ulrich Tehuacan -> Peggy Galaria Wozniak
Fatima Ajit Rockafeller -> Ajit Apu Daniels
Buffalo Vivenna Chowdury -> Oogex Han Kruchev
Fisk Zant Nightshade -> Serene Julio Fitzwilliam
Emer Atskuo Wojciechowski -> Aeryn Jareth Santa-Cruz
Wyrm Tyrian Hyprazia -> Ilya Garter Lezrimond
Maheen Jareth Faheen -> Dalinar Sam Gubler
Apu Fisk Occam -> Torol Eden Centauri
Cloud Ulrich Lezrimond -> Ulrich Jai Idaho
Aurora Buffalo Solaris -> Falkor Julio Zanzibrot
Buffalo Vivenna Chowdury -> Fenix Roroni Sol
Gurn Ashravan Wu -> Wyrm Ciri Centauri
Jareth Abril Pleides -> Han Nora Nesbit
Fisk Verla Leibniz -> ShaiLu Isabella PorSellik
Khan Raven Kent -> Llan Tonya McMillan
Leia Ronin Rodanza -> Apu Ulim GuYung
Maria Gandalf Kondo -> Tullia Icthyon
Leni Ryu Dryzt -> Gandalf Xena Torres
Echo Antonia Blanco -> Verla Peggy Skylocke
Thane Zoe Hemonotz -> Korath Shallan Nesbit
Ilya Tao Tehuacan -> Milo Thane Dostoyevsky
Vivenna Xianchu Ikeda -> Yun Leni Dunbar
Geralt Veebux Solaris -> Julio Ciri Kondo
Ulrich Jai Idaho -> Callum Sylphrena Mejito
